12 16
****************
*  *    *  *** *
* **           *
*  *  *        *
*  * * *     E *
**   *        **
* **  ** **  * *
*  * *      P **
***   K  *  * **
* *   *  **    *
*           *  *
****************