23 15
***************
* ***    *  P *
**E *  **     *
****        * *
*             *
* *   *     * *
* * *    ** * *
*   *  *   *  *
**    *  **** *
* *           *
** K*    *    *
*    ***     **
**         *  *
*   *         *
*    **    ****
**         ** *
*     **   * **
**       *  * *
* * * ** * ** *
* * ****  *   *
**   * *    * *
* *        *  *
***************