14 30
******************************
*   *****           K    * * *
**  *  * * *  * **          **
*          *   * ** E*     * *
* *  **   **      * * **    **
** *   *       ** *****   ** *
*         *  *   * *  *** * **
**       **  *         *  *  *
* * ** **     *  **   **  *  *
*     *      *   *          P*
*   *  ***  * *    *   *     *
*  * ** ** *      *   ** *  **
*  *           *  *          *
******************************