28 14
**************
***     **  **
* *P*   *   **
**    ** **  *
* * *        *
*  ** *  * ***
*         * **
**      *   **
* * *      ***
***    *    **
*     ** *   *
*     **     *
*          * *
** *  *      *
*  *     *   *
**  *** *    *
*  *    *    *
* *     *    *
*       * *  *
*  *  E    * *
*            *
*   ***    ***
***   *   * **
*     *  *** *
**  * *  *** *
** *  *      *
* *   ** K*  *
**************