28 13
*************
***  **     *
*       ** **
*  **  *   **
*** *   *   *
**    * * * *
** *   *    *
***     *  **
*   *  *  ***
*    * *    *
* *  ***    *
*     * *   *
*   * *  *  *
** **K    * *
*     *  *  *
**  * *     *
*           *
* * *    P  *
** *        *
* E ** * ** *
*       *  **
*      * ****
*        ****
*           *
**  ** **   *
*     ***  **
*  * *   *  *
*************