12 30
******************************
*      ****  * **P**   *     *
*  E**  *     *   *   ** *   *
**   *   * *    * * * *   * **
*     ** *    * * * * **     *
*          *         *       *
**         *K **       ** *  *
* **    *  * *      * ***   **
* *     *    * *  *   ***  * *
*      ** *  *      *    **  *
* * *** *   *                *
******************************