27 14
**************
*       **   *
****E     ****
*      * **  *
* *P* * * *  *
*  ** **  ** *
* *  *       *
*** * *      *
* * *        *
*     *   * **
*       * *  *
*  ***     ***
*  *         *
*     *  ** **
**        * **
**    *    * *
*    *   **  *
*  *   * * ***
**  *        *
* * **  **  **
*  *      *  *
*     *  *   *
*   **  *  * *
*            *
***   K  **  *
*   *  ** *  *
**************