15 12
************
***   ** * *
* *   *   **
*  ** **   *
* *        *
*      * K *
* **  *  * *
*  *    *  *
*     **  **
* * **   * *
* *  *    **
*     *    *
*   E *  P**
*        ***
************