25 12
************
*   *    * *
*   **     *
*  ** **   *
** ** **   *
** **   ****
*    * *  **
* ** *  *  *
*     * *  *
*  *       *
* *  K*    *
**     * * *
* **       *
* *   *  * *
** ** *    *
** *       *
** *  *  P *
** *    ** *
*    **    *
**         *
**  **     *
*          *
*   * * *  *
* *    E*  *
************