23 30
******************************
*   ** **  *   *           * *
*   *   **  *  **  *    *   **
*        *  * *      * * *  **
* *  * *   * *     * * * * * *
* *      **    *  *   * *  * *
*  *   * *  *   *    **   * **
* ***  *  *  *    ***        *
*   **  ** * ** ** *   *   * *
*       ** *** *  *** *      *
*        * ** * *     *   ** *
**     *     * *     ***  ** *
*          ***E    **        *
*         ** **   *       ** *
** **      * ** *    **     **
*  *    **  **  **           *
* * ** **  *   *       *   * *
* **    * *  *    P          *
*        *     *       **   **
* K  * *  * *   *     **  *  *
*  *    **  **     * *  *  * *
*  *        *  *    * * ** ***
******************************