30 13
*************
*    * *    *
*    **  ** *
*  ** *  *  *
* *   *     *
***   ** ** *
* E * **   **
*           *
*    K  *   *
*** *       *
*   *      **
*     * *   *
* **** * * **
*       *  **
* *    **   *
*  ***   *  *
*    *** *  *
***  *     **
*  **       *
*     *    **
*          **
*       **  *
**      **  *
* **      ***
**     *  * *
* **       **
* **        *
***  ** * ***
*P *        *
*************