18 21
*********************
*       * *  ***   **
**     *    **   * **
*     * *** * *     *
*      **       *   *
*   * ** **  *K *  **
*   * *          *  *
**   *  *    ** *   *
*   * *     **      *
* * *  *    ***   * *
*     **    *      **
**   *      * *  * **
*          * * *    *
*  *       P* **    *
*      ** ** *    * *
*        *E        **
* *  * *    **  ** **
*********************