13 21
*********************
**  *   *** *     * *
** **    * *  **    *
* *     *  *   *    *
*  E   *       **** *
*      *   ** **    *
* *                 *
*  *   **    **K    *
**  ** * *     P  * *
*   * * *   *       *
*       *** *  **   *
*  *      *   *     *
*********************