19 23
***********************
* *     *    *       **
* * * *  ** * * **    *
*  E      *    *      *
** *  **   ** *       *
*  * *      * ** *    *
*  *      * * *****   *
*     *  *** *   *    *
*  *    * * *         *
*      **     **  *  **
** **   *     **P     *
*   *    **       *   *
**    **   *  *      **
***      *   ****  *  *
*       **   K     * **
***   *       *   **  *
*      *     **  * * **
*  *   *   * * * *    *
***********************