14 14
**************
****P  *     *
*  *****  *  *
*   *  *     *
* *  **E   * *
*     *   *  *
* **   *     *
* ***     *  *
**        ****
*        *   *
*  * **  *   *
*  *  *  *   *
* *     *K   *
**************