19 19
*******************
*  *         *   **
* * *    *    *   *
* ** * *   *  * * *
*  *   *        * *
*   E** *  * * ****
*      P      *   *
***  * *    *  *  *
* *  **        *  *
*   * *        * **
***     * *    * **
*     ***   **  K *
***   *  ** ***   *
* * **     *  *   *
*            ***  *
*      ***  **    *
**  *   ***   *   *
**   * * * *      *
*******************