13 18
******************
*   **   **E    **
*  *             *
*   *    **  *****
** *        *  ***
*       *** *    *
* P  **  *       *
*          K   * *
* *   **  **  ** *
*    *  ***      *
*   * *     **   *
*   *  * ***  * **
******************