16 12
************
**    *   **
*       ** *
*  E     P**
*      *   *
* ***     **
** *       *
*    **  ***
**  *    * *
* ****     *
* *     *  *
* **   * * *
*****      *
*  *  K *  *
**  *     **
************