14 13
*************
*   * **  * *
* **     * **
* * *       *
*     ** * K*
* * *       *
*  *  *   * *
*   * *     *
* * *  * * **
* * *   P*  *
*   * * *   *
* * * * **  *
*E   * *    *
*************