16 15
***************
***       * * *
* E  * *  **  *
**     *   *  *
*  * *   *    *
****      **  *
***K *  *  *  *
*   *    **   *
*   ***  * P  *
*  **  * *   **
* *    *      *
**    *    ****
*  *    *  * **
*      *      *
* * *     *   *
***************