14 20
********************
*         *   * ** *
*   ** * K* * **  **
*       **  *     **
** * *   *  **** * *
* *E   *      *    *
***   *  *   *  *  *
* * *   *     P    *
*  *  **   * *     *
*** *     ***    * *
* **      * **   * *
*     **  *** *  * *
* *      **      * *
********************