15 30
******************************
*  *    *     *** * *     *  *
*     *          E  **  **  **
* ** * ***** *     * *      **
*      *  **      **   *     *
**     *      **** *     *** *
* * *  ** * *  *    P*  K    *
*     *  *   **  *   *  *** **
* *****   *  **    *     *  **
* *     *   ** *             *
**  *            *   *  *    *
* *          **    *     *  **
*  ***  ***   ***   **      **
* *      *    * *  ***  ***  *
******************************