20 12
************
* *   *   **
*          *
** *    * E*
**   *   ***
*  * *** * *
*        ***
***  * *   *
* K     ****
* *      * *
**  *    * *
*** ** *   *
*   * *    *
* *  *    **
***        *
*     * *  *
*   *P *   *
*  *       *
*          *
************