12 28
****************************
**           * ** *   *  * *
*  ** *         *     *    *
*    * *   **  *E   *   ****
*     **  *       *     *  *
* **     **         * **   *
*    * **P    * * **** * * *
* * *       *  *       * * *
** **   * *    **       ** *
*  **       **  **  * * *  *
*  *    * *   * *    K*    *
****************************