14 26
**************************
**K                 * *  *
*    *    *   **   ** * **
*       * ***      **** **
** * **         *****    *
*      **  *  *  *  *  * *
*  **      **  * *  * ****
** *  *    ** **      *  *
* **  * *     *  **      *
** *   P            **   *
** E  *        *         *
*          *     **  *   *
**     *     *  *   *  ***
**************************