14 20
********************
*  *              **
*   **    * * **   *
*   *** *   *      *
*  E  *  P   * *   *
* *    *   ***** * *
*  ***  *   *      *
*     *        **  *
*  ***  *        * *
****   *     *    **
*   *  *  ** K * * *
** * * *  *        *
*  * *  * *  *  ** *
********************