28 15
***************
*    **  *    *
****          *
*   * *      **
*** ***       *
* * ***  *    *
** **       * *
*  *      K*  *
*       *  * **
** **** *     *
*  *P *       *
* **  * * *   *
*        * *  *
**    *  **  E*
**  *     * ***
***   * *  * **
***   *       *
*     ****    *
*          ** *
***  *     *  *
*    * *  * * *
* **    *   * *
* ***     * * *
***     **  * *
*     *    ** *
*   *     *  **
*        ** * *
***************