13 31
*******************************
* * **   K   E* *    *  * * * *
*  * ***   *   *   *          *
*      *    **    P   *   *  **
**    ***  *  *     ***       *
**       *  *         *  *    *
* *   **   * **  **           *
* *           *      *  **  ***
* *  * *****    ***   *   *   *
*    * *    *  * **  *    *   *
*      *     *        * *  ** *
*  ***       *  **     *    * *
*******************************