17 21
*********************
*     *    *   *  * *
* ***   * *     ** **
*  *     *   **     *
*       *  * **K   **
**    *  P**       **
*  *    **  * *    **
*       *  * *   E  *
* *        *    *   *
***   *            **
** * * *** *  *    **
*   **  *   *       *
*     **  *  * *  ***
*    *   *  * **  ***
* * ** * * * *      *
*  *   **  *  ***   *
*********************