27 16
****************
*   **  *   *  *
**         *** *
*  *  * * *  * *
*        * *   *
* ****        **
*   *** **  *  *
*     *   *  * *
*    * *       *
*    * *   * * *
**  *   *  * * *
* *    *      **
***    * *   * *
*  K        *  *
**    *        *
* P      * * * *
* **  *E  *  * *
*     *   *    *
*  * **    *   *
**     *  * *  *
*  **     *  * *
* * **      *  *
* *   *    **  *
* * *        * *
*      ** **  **
* *  * *   *   *
****************