18 19
*******************
*   *      * * ** *
*       *  *K* ** *
*           ** *  *
*  **    * *    * *
*       *    * ****
**  **   *        *
*   *     **  *   *
* E*    ***  *    *
**    *  **   *   *
**     * *       **
** * *            *
* *    * *  P   * *
* * * **    ** * **
** **         **  *
*  **      *   *  *
* * * ***     ** **
*******************