12 26
**************************
* *       *     *  * * K *
***    *        **    ****
**   *   ***   *   *    **
**       *      ** * * * *
*   *       **  * *  *  **
** *  * *   E*   *    ** *
*     *        *  **  ** *
*  **     **  * ***    ***
*   *   *   *     *     **
* *      *P **     *   * *
**************************