12 14
**************
*     * **   *
**      *K P *
* **   *   * *
*  *     *  **
*  * E *  *  *
*  *       ***
***   *    * *
**   *       *
** *  *   *  *
*  * * *  * **
**************