21 15
***************
**   E       **
*     *    *  *
******  * *   *
*  *  * *  *  *
* **  *   *   *
*      *   ** *
****   ** *  **
**** *     *P *
*  * * *   *  *
* *  * * ** ***
*  *   *    ***
**   K*     * *
**  *         *
*  * *        *
*        * ** *
*    *        *
* **   * *    *
**      *     *
*   ***     * *
***************