25 20
********************
* *       *        *
*  *    *       ** *
*  *   *  *        *
* *   **   *      **
**   K  **  *      *
**    **   *       *
***  ** *  ***     *
*  *** *  *  **    *
*   * *    *  **** *
*   *  *   *    *  *
*              *****
*  *** **          *
* *  *  ** * *  *  *
* * ****       * ***
*         *   ** E *
*    * **  ***     *
*          * * *   *
* *   *   P        *
***  *     ***** * *
* * *    ** ****   *
* *    *  **       *
*** **  *      * * *
*      * * * *   * *
********************