13 32
********************************
*    ****  **      *   *   *   *
**        * *  *    **   * * * *
**   **       *          *  * **
*     *   **   *   **  * *   * *
** *  *     *  * *  *       *  *
* *  *      *     ** *  * *    *
*    **  *  *     **   ***     *
**  ***  *   **  *  *   **     *
***     * **  P**            * *
* *         *            *     *
***   *K E  *  ** *          * *
********************************