24 13
*************
**     *K   *
**  ***    **
*  ** ** ** *
* *         *
*   * **    *
*     *    **
** * *      *
*      *  * *
*  * *   ** *
* *   *   ***
**   *  *   *
**       *  *
**   ****   *
** *        *
* *    *   **
*    **    **
* * *  *    *
**    *E ** *
**      P** *
*    * *   **
** * * *    *
*   *     * *
*************