23 15
***************
* *   *   * * *
* *  * *     **
*** ** *  **  *
*        * ** *
*     * *** * *
* ** **   *   *
*    *   *   **
**            *
*   *E **     *
**   K*   *  P*
*   *    *    *
*  *** *     **
***    *  * * *
*  *   *      *
** *    * *  **
* ** * ***  ***
**         *  *
*   * **      *
*  **        **
*** ** *  *   *
*      *      *
***************