15 32
********************************
*        **  *     **      *   *
*   * *   P  ***     **    *   *
*  *      *   * *  **       *  *
**    * ** *E  **   *     *   **
**   *      ** * * * *      * **
* *  *     * *        *  *     *
*    *    *   ** *    *     * **
*        * *  *      *  ** *   *
*      *   ** ** * *      *    *
* ** **             * ** *  *  *
* * **  *   *** * *  *    *K   *
*        * *  * * *   * *      *
*      *   ***      ** * **  * *
********************************