31 13
*************
* **   *  * *
*      *    *
*   *  **** *
* *    *    *
*    * * E  *
*K         **
*           *
**        * *
*  *    * * *
*  ** *    **
** *  *    **
*    ** * * *
* *        **
*       * * *
**  *** *   *
*   *   **P**
****   * *  *
*        ****
* * **    * *
**          *
* ** *** *  *
**  * **    *
***  *   ****
*  **  *    *
* **  *  *  *
* **     * **
**          *
**   *    * *
*  *    *   *
*************