13 13
*************
**** *   *  *
*     *    **
* **   * * **
*    *** P  *
* ** ****   *
*      K * **
*     ** *  *
**  *     * *
*      *  * *
*         E *
*           *
*************