19 14
**************
* * *  **    *
**  * ***   E*
*      * *  **
*     * ** * *
*      *    **
**  * * **   *
*      * *   *
*      * *   *
**      *    *
*   **   *   *
**K          *
*   *   *    *
*   *    * P *
** **  **   **
*    **** ****
*  *** *     *
**     **   **
**************