16 24
************************
*   *   **       *     *
*   *       *    **  * *
*  *  * * *   **      **
**     *      *    * * *
***      * **    ***   *
*  *     *  * *     * **
**   *   ***   ** * * **
*      *  * *   ** **  *
***E*      *     *     *
*     *   *  *         *
*** * * * *         *  *
*  *  *     *   *      *
*    **   ** **  **  * *
**    *    **   *   P K*
************************