19 12
************
*      *   *
**        **
*        * *
** *      P*
*  *      **
***   *   **
** *    *  *
* *    *  **
* **** *   *
**E *** ** *
**   *  *  *
** *       *
*          *
**  K **  **
****  * *  *
*   *     **
* *  *   * *
************