12 16
****************
*  *        *  *
*      * ***   *
*   * ** E*   **
**  * **   *   *
**  K *   **   *
* * *  *       *
*     *  *   ***
**     *   * * *
* *        **P *
*  *** *       *
****************