14 18
******************
*  *   *      *  *
*       *  *    **
*   *     **   ***
*        * P*    *
*  K*  * * * * * *
*     * * **     *
*     * * *  **  *
* *   *  ** * ** *
*  *   * * **  ***
* * ** * **    ***
* E*  **        **
**  *  ** **  *  *
******************