16 30
******************************
*     * *  *   *   *         *
* *    * *      * ** **    * *
**           *   *      *    *
**           *   ***    * *  *
* *              * ** *   *  *
*  *  * *   * * ** K    ***  *
**** ** *        * *  * *  * *
* **  *           * * *  **  *
*     * E       *      *    **
*       *   ***     * *  **  *
*     *  * *  * *        *   *
** ***  *P     *   *  *    * *
*  ***     *    **    *   * **
*  *  **   *   *   * * *    **
******************************