32 18
******************
*         **     *
*  *   *    *   **
*     **        **
* *  * *  *  *   *
* *  *      *   **
*   *     *  *   *
*       *  *  * **
**      ***    * *
* ** ** *  *     *
*           **   *
*E*      *     * *
* *         *** **
*     * *      * *
** * ****  * * * *
* * **   ****  * *
* **    *  **    *
*   **       K** *
*           **   *
*  **     *      *
*      *   **    *
***        **    *
* ** *     **  P *
*   *  *    *    *
*      *  *      *
**  *     *** * **
*       * *  *** *
**   *  **      **
**** * * ****    *
* *  ***     *   *
*    *  **  **  **
******************