20 22
**********************
*       *    *   *** *
*         *  *    ** *
*        P*K     * * *
*       *     * *   **
*   **   **     * * E*
*   *               **
*          *  *      *
**  *   *     *   ** *
**    * **  * * *  ***
**  ***  * *  * * * **
**          ***     **
*   *  * *        *  *
*  **          *    **
* * * **  *  * *  ** *
*  **     *       ** *
*    *  ***    *  ** *
*    * *  *   * ** * *
**  *  * **         **
**********************