15 19
*******************
* * *   *    **   *
*  **  * *    *   *
** * **        *  *
* *         **    *
****  **  *       *
* * *    * ** *   *
* * ** *    *     *
*    * P      **  *
**K      * *  *E **
*  * ******     * *
*  ** * *  *  **  *
**    *      * *  *
* *  *        *  **
*******************