17 12
************
*   * **  **
*          *
*E   K*  * *
*          *
** *  *    *
*    * *   *
*    **    *
****    *  *
***   **** *
***P * **  *
**    ** * *
* * *      *
* *     * **
*  **   * **
*       *  *
************