19 24
************************
* *    ** *     *   *  *
**    * * K**  **   ** *
*      *  *    **    * *
*          *  *  * **  *
*  *   *  ***** *    * *
* *   ***    *    *    *
*   * * *      * *     *
*  **   *  * ** *    * *
*P*   *        *  *   E*
***         *  **** ** *
*      *      *        *
* **   **  *          **
* *      *     *    ****
*    **  * * *        **
*   *    **  ** * ***  *
* **      *  * *     * *
* * * ** *             *
************************