18 18
******************
* *  ** *    *   *
*    ***     ** **
* * *  * **** * **
* *    *         *
**  *   *** *P * *
*     * * *     **
*  *       *     *
*  * **    **   **
*             ****
*        * *     *
*    *    **  *  *
** *   * * * * * *
*K   *     **   **
** E  * ** *     *
**   *     *   ***
*    *         * *
******************