13 21
*********************
*  *    * * *       *
*  *  **  *     ** **
* * *  * *  ***     *
*P    E  *      **  *
*    *      *  *  * *
* * *  K ** ** *  ***
*   *   * *     **  *
* *   *  *   *  *   *
* *  *   *  **    ***
**  *  ** *        **
*  * *    *  *      *
*********************