20 15
***************
**     * **   *
** * *   *  * *
*   **    *   *
*      *  **  *
* **      **  *
**    E * *  K*
* * *   *  ****
*  ** **   *  *
***  * * * *  *
*  *          *
*** *  *     **
***  *     ** *
*       *  ** *
*          *  *
*   **       P*
*   **      * *
* *   *  *   **
*** *         *
***************