26 14
**************
*  *    *    *
*   * *   * **
**   **   *  *
*    *   *   *
***         **
*    *  *    *
*         * **
* * *    *   *
**    *   *  *
***   ***  * *
*   * *   *  *
**   *    * **
*  **    **  *
* *   ***P   *
**      *** **
* *E *       *
* * *  ***  **
* *       *  *
*  ** *   *  *
*    *      **
*  *  ** *   *
*   *   **   *
** *  *      *
*   *      K *
**************