13 16
****************
*        *     *
*            K *
**    * **    **
**     *    *  *
* ***   *  ** **
*    * * *  ** *
*  *      **  **
*      ** *    *
**  *          *
*    *  * *  E**
*    * * *P* ***
****************