19 24
************************
**   **  *   *       * *
**     *   **   * **E  *
* *           *     ** *
*   *   * **       *  **
*    *   * * * **  * * *
* * **  *K **       ** *
* *       *      * * * *
*    **     *      * * *
***  *      P    **    *
*    * * ***   *  *    *
*  * ***    * * *      *
*  ** * * *        *   *
** *   * **  *  * * *  *
* *    *        * * *  *
* *   **  * * * ***    *
*  * *      * *        *
*         *  *  *  *   *
************************