16 13
*************
*     * *P  *
*    *      *
**     *   **
* *  K    * *
**   *  **  *
**   * ***  *
*    *    * *
**  ***   ***
* *  * **  **
*   * **  * *
*      **   *
* *   *   * *
**** * *    *
*   E *  ** *
*************