18 12
************
*    **  * *
*       *  *
**   *     *
*    * * * *
** *    *  *
*  ***    **
* ****    E*
**P  *  *  *
* * **     *
*      **  *
****  K    *
****    ** *
*  *** *   *
** *   **  *
*    *     *
*   *      *
************