17 20
********************
*      * *   *  ** *
**   *      *     **
* *   *    *  * * **
*        P      ****
*  * * **   K  * ***
*       * *   * *  *
* *       *    * ***
*    **  *      *  *
*     *  * *    * **
***   ** *  *  * * *
**    *   *  **   **
****      E *   *  *
* *** *   * * *    *
*           **   * *
**       **  * *   *
********************