26 16
****************
*  *   *       *
* * * *  *     *
* * *      ** **
* **  **     * *
**     *     * *
* *          ***
**  *  *  *  * *
*  * *    **   *
*    **    *  **
** * * * *     *
** *  *   **   *
*E *   *     K *
**   P*   **  **
*  *        *  *
** *   * * **  *
*    *** **    *
*      ** * *  *
*  *** *  *    *
*** *     ***  *
**  *  * * *   *
* ** * *    *  *
*     *        *
*** *    *     *
* *  **  *  *  *
****************