13 21
*********************
*   ** *   K      ***
*     * **   **  * **
*    ** *  *    *****
**  P      *     *  *
*    * **  *     *  *
** *  **   * **  ** *
**  *  **    *  *   *
*      *      *    **
* * * ***     * *   *
*   * *      *  *** *
*     E        *    *
*********************