21 18
******************
**    *  *  *    *
*   * ***  *   * *
**         *  E  *
* * *    ***     *
*  *   *     * * *
*    **    *   * *
***   ***      * *
*     *       *  *
** ** **         *
*   * P**   **   *
*  *    *****  * *
*   **   *      **
**   * ** *      *
* ** *  * **  *  *
*  *       *  *  *
*       ** *     *
*  **  **      * *
* *   *          *
*  ** *       K **
******************