30 31
*******************************
*   ** ** *       ****   *  ***
* ***       * * *** * *   * ***
* **** **     * *       **   **
*       *    *      *  * * ** *
*   *  **  **      * **  **   *
*  * K  *   *  * *    **  * * *
*   *     *   **     * * *    *
*** **  * **     **      P    *
**       **    *  *  ***** *  *
* **   *  **    *      *      *
*   ***       *   *           *
*  * *  *        *  **  * *   *
** *          *  * *        * *
*    *       *  *   *         *
*    *       *    *   *** *   *
*  **  *  *      **  *     *  *
***        * *     **    ** * *
***  *          * ***   *  *  *
* **   *  * * *    *       *  *
*   * * * *     *   *  ** *   *
** *     **   * *       * * * *
* *      * *     ** * ** ***  *
*** * *   * *   *** *    * * **
**  *        *     *   *      *
*  *         *  *      *   * **
*         *     E  *   * **   *
* * ***  *      ****    *     *
* *  *  *          ***** ** ***
*******************************