21 20
********************
* *      *       ***
***             * **
* **    * *   *  * *
* *  *        ***  *
*   K   ** *** *   *
* *   * *     **   *
*       **  *   ** *
*      *  P   * * **
*  *   *  * **   *E*
**      *** *  ** **
***        * **  * *
*  ***  *          *
* **  *          ***
****           * ***
*  * ** *   * *  ***
*  **    **      * *
***        *       *
***  * **  **      *
** *    * *        *
********************