22 14
**************
*      **    *
*           **
***   * *    *
*   *    *  **
*    ** ** * *
* * *        *
**E      *   *
*   ****  *K *
*     * *    *
** * * *  *P *
*   * *  * * *
*  ***     * *
*   ***  *   *
*            *
*        * * *
* *      *   *
*   *  * * * *
* *  *     ***
***  **** *  *
* *        ***
**************