22 15
***************
* * *   ** *  *
*      * *    *
* * *       * *
** *   *      *
**  **   *    *
** *       *  *
*       * *   *
*    * * *  K *
*   *     *   *
***      **  **
*   **  ** * **
* *   ** * *  *
*    *    *   *
****      P*  *
**  * **   ** *
* **E   *    **
*      ** *  **
*   **     * **
* * *  ***  ***
*     * *     *
***************