16 17
*****************
***   *   *     *
*    * *  **    *
*  * *       *  *
*  **   * * *   *
*   *P          *
*   *     **    *
*  * *   *      *
*   *  ***  *K  *
*   ** ***      *
****    *   *  **
* E*     **  *  *
* *    *     *  *
* *        *    *
*        *    ***
*****************