19 14
**************
*            *
**           *
***   *  *** *
* *  *   *   *
*   **   *   *
*    * *  *  *
* **  **  ** *
*** *     *  *
* *   *   *  *
* * *P  E  * *
*    *     * *
**   **   *  *
* * ***      *
** K ***     *
***   * **** *
* * ****     *
*        ** **
**************