22 19
*******************
**  * * *   * *   *
*** *       * *   *
*    **      P    *
*   * ** *       **
**     *        * *
** *   *   * *  * *
*  * **     ** *  *
*     *  *   **   *
** * *    *    * **
*    *    **      *
*  * *   ****    **
*  * *     *   ** *
* * *     *  **   *
*    ***    *     *
****   **     *   *
** *         *   **
*       *  *    ***
*   *     *      **
*  ** * *   KE* * *
* ** *   *    *   *
*******************