30 14
**************
* *   * *    *
*   *      * *
*    * ** * **
*    ** **   *
* *****      *
*  * * *   * *
*   *  *     *
**  *   *    *
*   *E*   *  *
*   *  * * ***
* **      *  *
*  *P   ** * *
*   * * **   *
* *  *** *   *
*    ***  ** *
*    *    ** *
*  *  *   ** *
*   *** **K  *
*  ** *    * *
*   *   *    *
**  *   *    *
*          ***
* * * *   * **
*    *       *
* * *   * ** *
**   **    * *
*       **   *
*       * *  *
**************