31 12
************
* ** **    *
**   * * ***
* *      * *
*    *     *
*   *  *  **
*   * **   *
*          *
* *     *  *
*  E       *
*   *      *
*  *  *    *
*  P **** **
*    *   K *
*   *     **
*  *    * **
**   *     *
* *** *  * *
*   **     *
* **      **
*** * *    *
*        * *
** *    *  *
* *** *  * *
*     *  * *
*    * * ***
*   *    ***
***  ** ** *
*        * *
* *    *** *
************