12 19
*******************
*   * * *     E   *
** *   *  *   *** *
*  *              *
**    ****    * * *
** *   *P*  *   * *
*       *       * *
*K *        **  * *
****   * * *  * * *
*   *  * *  **   **
*       **   *    *
*******************