20 19
*******************
**  *  **   ***** *
*            * * **
*  *      *  *E   *
*  ***     *   ** *
* *    ***  **    *
*  * *       * *  *
*  *    *  ***  P *
*      *    *   * *
***   *     **  * *
* * **  *  *     **
*K  *     ***     *
*        * ** ** **
*     *  *       **
*   *    *    **  *
***  **         * *
* * * ** **    *  *
* *       *    *  *
*    * *      *   *
*******************