28 12
************
*   K   P  *
*  *     ***
* ** *     *
*      **  *
*   * * ** *
*          *
** *   *   *
*  *       *
**     *   *
*        ***
**    *   E*
*        * *
** *   * ***
*    * * ***
* ** * *   *
*** *  *   *
* ***      *
* *   *  ***
**  * **  **
** ***     *
*  *   * * *
*  *     * *
*   *   ** *
* *  ***   *
**     *   *
*    *    **
************