22 18
******************
*  *  *   **     *
*     *** * **   *
* ***  * * *    **
*        **  ** **
**    *         **
*  *     *  *    *
*       *    * * *
*   ** *   **    *
*  *    *  *     *
*     *    *   ***
* **          ** *
***     P  *   * *
**      *  **   K*
*   *      * *   *
*     *  * * *** *
** E   *  *      *
*    *  ***  ** **
*** * * *  * *  **
**   *  ****  *  *
* *              *
******************