26 15
***************
**  *       * *
*   *** *     *
*  *   ****** *
*   *  **  *  *
*   *  *      *
*   *  *  *   *
*    * *      *
**       **  **
*      *   *  *
*  * * * ***  *
*        * K* *
*   * **  * * *
*    *    *   *
*    * P*   * *
* *      *    *
** *       ** *
***     *  *  *
* *  *     * **
** *  **      *
*  **  * * ** *
**    ** *E   *
* **  *    *  *
*   *  *  **  *
**   * *     **
***************