19 15
***************
** **   *  P **
* ***    * *  *
*     *     * *
* *    *      *
* **     ***  *
*    * *** ** *
*    * ** *  **
* *   *    * K*
** *   *  *   *
*       *   * *
*            **
*   *  *    * *
*          ** *
* * *  *  * E**
** **   *  * **
*  *          *
*  *        * *
***************