19 17
*****************
*    *       *  *
*   *  *        *
** * * **  *  * *
** *  *P*  *  ***
*    *   K      *
*  * *     *  * *
* * *    *   *  *
* *    *       **
* **  ** * **  **
*   **     *    *
**  * *    ******
*        *   *  *
**     *   *  * *
* *   ** **   * *
* *    *  *     *
* *   ***  * * **
*  * E    **    *
*****************