18 14
**************
*  *      *  *
*  * *       *
***          *
* *  *      **
*       **   *
*    **      *
*        K   *
* ** **   ** *
*   *  ***P  *
*        *   *
* **       * *
*  *   **    *
**** *   *   *
** * ***  *  *
** *    *   **
** *E   * ** *
**************