19 22
**********************
* * **    ***      * *
*     *   **  * P * **
* *   * * *   *    * *
*  ***      *    *   *
**                 * *
*    E  *      *   ***
*    *        *   *  *
** *  **   **       **
*  *    *     **   * *
* * *   *** *  * *   *
**          *       **
* ** **  **K **     **
** **     **   * *   *
** *  * ****      ** *
*      **          * *
* *                * *
** *    *     *  *  **
**********************