13 17
*****************
* * K **  *     *
*    ***     * **
* *  *        * *
*       *E  *   *
*   **   *      *
****    *       *
*  **       *   *
* *  *** *    *P*
**   *   *    * *
** *   * *   * **
*   *    *      *
*****************