16 17
*****************
* *    *  *     *
*** ***       K *
*     P * * * * *
* * *    * * ** *
* **  * * * * * *
* **  *        **
** *     *  * * *
* * * * **  *  **
* *          *  *
* *  *   *  *   *
**     *        *
* E**     ***   *
*  *    *  *    *
* *   *   **   **
*****************