16 21
*********************
*    * ** *    **   *
**  **  ** *    P*  *
*K   *      *       *
*   **  * **    **  *
**             **   *
** ** *     ***    **
* *    * ****       *
*   *     *      ****
** *  *           * *
* *   *  *   *  *** *
*       * * *       *
*    * *    **  *** *
*          *  *     *
*  E     * ** *     *
*********************