12 19
*******************
*** * *  *   *    *
*  *K  E      *   *
** *     *   **** *
* *    P ***** ** *
****  * * *    *  *
*       * *   *   *
**      *  *      *
* *   *    ** * * *
*    *   *  **  * *
*  *  * *    *  * *
*******************