19 17
*****************
*E  **        ***
*      *     *  *
* * * **  *     *
* * * * *   *   *
* *     ***    **
*   *   *  *    *
*            * **
*   *     K *  **
* ***       *  **
*    ** * *     *
* **  * ***  *  *
* *     *  *    *
* *           ***
* *  * *   **   *
*   * *    * ** *
**    *      ** *
* *   *   *  P **
*****************