27 29
*****************************
***  * *   * * * *  *       *
*  *  *    **     **        *
*     **  *      *        * *
**  *   *       * *  *  *   *
*     E      * *            *
*     **** * * *  * *   *** *
* *         **** P    * *   *
**       *     **  **  *   **
* *** *     ** *     * *    *
*  *   **   *  ***   * *** **
**   **      * * *  *      **
*     ** *  *   * * *  ***  *
**      *    *      ** *    *
*  *   ** *     *           *
* *        *   **    *  *   *
* ***   *  *     **     **  *
*** *  *      ***     **    *
** ** * ** *  *    **    *  *
** **   K *  *   *   *      *
*       *  *    **  *  *  * *
*    **      * ****    ***  *
* *  **     *         *     *
*  *   *     **    **    *  *
*  *            **** *  *   *
*    *      * *    * *    * *
*****************************