15 18
******************
*   **         * *
***     ** **    *
*  *  * ** * * * *
**    *  *     * *
*   **  * * * ****
* *  *   *    *  *
*  *   *   * *  **
**PK **   *  * * *
*   *      *     *
*     * E* *    **
* ** *    *      *
*   ** * *   *   *
*   *        *  **
******************