24 13
*************
*  ** *   ***
*  ** **    *
* * *       *
**   *      *
*   ***   ***
*  K  P*   **
*   E    *  *
*   *   *  **
**     ***  *
*   * *   * *
* *         *
* **   * *  *
*     **    *
**      ** **
*  * **    **
*    ** **  *
***** *   ***
*     *  *  *
*  *  *     *
*   **    ***
**          *
*           *
*************