14 19
*******************
**            *   *
* **   ** *     ***
*       ** *      *
** * *  **      * *
**   *   * * *  * *
* *  *   *** **   *
* * **        *  **
*  ****  *E *     *
*  *  *           *
*     P* *  K  *  *
*      *  **    * *
** **       *    **
*******************