14 19
*******************
*  *      *P  *   *
*   E      *   *  *
*    ***  * ***   *
*         *   ** **
* * * *          **
* *  *   * * *** **
***      * *      *
* *       * *     *
*  *  ** *   * * **
*       *  *** *  *
***    **       * *
*    * *K*     *  *
*******************