25 14
**************
*    *    ** *
*  * *       *
** **     ** *
*    * **   **
** *     *   *
***         **
*    ** *   E*
* ** P   *  **
**    *  **  *
*   *  *   * *
***    *  *  *
*   *    *   *
*       **   *
** *    *   **
* **     *** *
*  ** K   *  *
** *    *    *
**     *   * *
***    *     *
*  * *    * **
* * **    *  *
*   *       **
**     *  *  *
**************