17 20
********************
*    * *          **
*  *         *     *
*    **  **      * *
*      *  **       *
* *  * *** ****  * *
* ** *  *        * *
* *   * **  *  *  **
*    E  *  ** *    *
*   **      *   * **
*       *** ***  * *
**   **   ** ** *  *
**   *   P   * *   *
*    *      *      *
*        ** *K**   *
** **          * * *
********************