16 26
**************************
* * **  *  * * **      * *
* *     * ***     *  *  **
**        *  **     *   **
* ***     *   *   ** *   *
*   *  *         *    *  *
*   **   **   *    *    **
**   *       E*    ** *  *
*        *    *    *   * *
*   *       * *         **
***  ******  * * *  **   *
*  ** *    **    *       *
*     * *        *    ** *
*   *  *  * *   * *   PK *
**   *   * * **     *    *
**************************