16 14
**************
* *    *     *
* * *      * *
*      *    **
**  **   *  P*
*     ** * E *
*       *  * *
*    *  *   **
*   * **  *  *
*  * * **   **
*   *    **  *
*  *     *   *
***  * *** * *
** K        **
*  *    *  * *
**************