19 18
******************
* *      *    ** *
*      *   *     *
* **  *   * P*  **
*** *   *      ***
*        * ** *  *
** *           * *
*  *     *      **
**      **    * **
*  *     ** **   *
*   *         ****
* **  *    *    **
*** *   K   *    *
**  **  *  *  * **
*             ** *
* ****  **   **  *
* * * *    *     *
*      * * E  ** *
******************