12 14
**************
*  * **  *   *
*  * *       *
**    *   K***
* *     *  E *
*        *  **
*P  *      * *
*   ***    * *
*  **       **
* *  *    *  *
*   *    *  **
**************