13 28
****************************
**        * EP**         ***
* * * * *  **    *         *
*        * *   * **      * *
* * *   *    **  *   * *   *
**    ** * *  *  *     * * *
*           * *   * **     *
*    *  * *    **   *      *
* *  * *K *     *    *  ****
* ** * *      ***  * *     *
*** *     **   * * *   **  *
*  **    *        *        *
****************************