13 15
***************
*        *    *
* **    **    *
**    *  * ** *
*E *  *      **
**    *     * *
** * ***     **
*  *  * *  *  *
* *   **     K*
*     *  * *P *
*         *****
*           ***
***************