22 16
****************
*        *  *E**
*   **   *     *
**  *   * * *  *
** ** ** *  P  *
*  *  * *      *
* *      *    **
**             *
*       *  *  **
* *     *      *
** ** *  *  ** *
*  *     *   * *
***  **  * *   *
*       * * * **
*       *    K *
* ** *  *    ***
*  *   ***     *
*   *    *     *
* * *    **  ***
** *  *  **    *
*   *  *    *  *
****************