19 22
**********************
**          *  **    *
**  *        *    *  *
*    *     ** *  *  **
* *    *      * * *  *
*   * *   *  * *  ** *
***       ** **  *  **
*      *          ** *
* *    **K**  P    * *
*     * *  * * *    **
****  ** * * *       *
**       **  * *     *
**     *  *   *   *  *
*  **  *     **   *  *
*E   *   *  *      * *
**    **  **       * *
*  ***  **           *
**       ** * **   * *
**********************