17 24
************************
** ***   * ** *   *   **
*   * *     *        * *
** *  *      *    *  * *
**    **         * *  **
*    ** *     * *      *
*    **    *    * *    *
* * *   * *     *   * **
*        ***  ***  *   *
*         *   * *      *
*** *   ** * * * * **  *
*   * *     *  **      *
** * *  * **           *
*   ** **  *  K  *  *  *
***        **    * *   *
**   E     P  *     ** *
************************