19 15
***************
*    *   **   *
*     *     ***
*    **       *
* **P  **    **
*        *** **
**  *****     *
*** *   *     *
**   *     E* *
*K          * *
* *         * *
*  *      **  *
* **        * *
**       ** * *
* **   ***  * *
* * * * **    *
* * *  *   *  *
*       *   * *
***************