16 28
****************************
*        **    * ** *      *
* * **   **  * * * *   *   *
****     * *    ** *   **  *
*   **  * *           * *  *
*      ** *         *     **
*  *    *  * K   *     *   *
* * * *  **     * *  **P   *
*  * *   *      *       ** *
*     *   *   *   *        *
*       *    *E*        * **
**     *****   **  *     ***
* *          **** * ***   **
*            * *** *       *
*   ****   *** *   *       *
****************************