14 22
**********************
*** * *    *    *    *
*     * *   *      ***
*      *** *  * ** * *
* * P  K***         **
*          ** * *  * *
**    **** *   *     *
*   *   *      *    **
*    *     *  *      *
*        ***   * *   *
*E *  *     * ***   **
*  *  ** *     ***** *
*  *   *** ******    *
**********************