14 30
******************************
*       *               * *  *
*   * * *  * *** *   *      **
*  *     ** ** *  * K   * *  *
*  * *        * *P  * * **   *
*E        * * *  **   **     *
*      *    *  * **  *       *
***        * *    *      * ***
*  *             **      ** **
* *    * *    *   **     *** *
**   *     * **     ** *    **
*** *        *   * * **   *  *
*  *  **     *  *      *     *
******************************