23 18
******************
* * *  *  * * *  *
** *** *        **
*  P **    *  ** *
* K        * *   *
*    ** *       **
*  **     *     **
*     * * * ***  *
*  *     ****  * *
*  *  *  *  *** **
*E *     ***  *  *
***        * *   *
**   *           *
* *** *  *       *
* *  *   *       *
*  *  * **      **
* * *** *** *    *
*    **    *    **
*   * *  **  **  *
*     *        ***
*    ** *   *    *
*        *   *****
******************