17 27
***************************
**  *  *  *  *  *   E*  * *
*        *   * *  * *  ****
*          **  **       * *
*** * *       * **  *** K *
*  ***     *  *        *  *
*  * **    * *    **    * *
** * *       *    * *  ** *
* *              * * *    *
*     *  ** * *     *     *
*P        * *   **      * *
**    **    *   *     * * *
* **       ** *  * ** * ***
* *  *   *  *      ** * ***
**         **  * *       **
**   *    **   *     *  * *
***************************