24 12
************
*   * ***  *
*          *
* * *      *
**         *
* *****   **
** *   *   *
**** *** * *
*  *  ****E*
***  *  *  *
* *  *     *
*   *  * * *
* **   *  **
*    * *   *
*    *  K  *
*   *    * *
* *        *
* P      * *
** * *     *
**  ***    *
* *     *  *
**         *
**  *    ***
************