20 16
****************
*        **    *
*       *   ** *
*    **  *  *  *
*      ** *  * *
**            **
*      ***   ***
*     **  **   *
*   * * *   ** *
**     **  **  *
* **    *     **
*  **        ***
*  *     * *  **
*  K*  *      **
* ** ** ** * * *
*   ***    *  **
*       E **   *
*   *   * P   **
** *   **     **
****************