12 18
******************
* ** **  **    ***
*   *     **  *  *
****   **  *     *
* K    *    *    *
*   *   *   ***  *
*   *    *     ***
*      * *   *   *
*  ** *     *  E *
* *  *  *   * P  *
* *          *   *
******************