14 18
******************
*  E       * *   *
*   *   *   **   *
** **     * *    *
**       *     * *
**  * *  *  *   **
* **       *    **
**    **  *      *
* *  ***         *
* * K***  *  *   *
* *    *  **  ** *
*   * * * P  **  *
*   * *   **   * *
******************