16 17
*****************
*** ** * *   * **
*  **     * *   *
**  **   *      *
*   **          *
*  ** * P  *   **
**  *  ***     **
*     *  **    **
** **  *     ** *
*  E *   **     *
** *     *     **
*          K    *
*     * **      *
* *      *    ***
** **         ***
*****************