18 12
************
****     ***
**   *    **
* *        *
*  * *  * K*
* * **  * **
*   *      *
*  * * *   *
**E **** * *
**  *      *
* *    **  *
*       ****
*          *
**        **
*   **     *
*** * **   *
*P *  *   **
************