15 13
*************
* ****  *  **
*   K* * *  *
*   * **    *
** *  E     *
***       ***
*    **     *
*P    *    **
*  * *      *
*           *
****    **  *
*    *  **  *
*** *       *
*       *   *
*************