21 20
********************
*         *   * * **
*      *    ***   **
*            **  * *
** *   * *         *
*  **     *      * *
*   **  *   *   *K *
*  *   *  *   **  E*
* * *   *   *      *
** **  ****  **    *
*  * *  **P  **    *
* * * *  **  **    *
*  * *   * * ***   *
*  **  **  *       *
**    *       *    *
* * * *    **  *   *
*         ***     **
* *      *   * *  **
**   *      ****  **
*  * * *   * *   * *
********************