23 25
*************************
**          *      *    *
* **         *   **    **
* *  ** *       * *    **
*    *   * * * *  * *   *
**           *   **  *  *
*      **  ** *    * *  *
**         *  **        *
*  **   * * * *         *
* *  * * * * *   * *    *
* *  * * **    *    * * *
*  ** *  *   * *     ****
**          *       **  *
*     * * ***   P      **
* **  * * **     *     **
* *  * ***     *   * ** *
**    K* *  *    * *    *
** **         *  *   *  *
**  *   ***        *   **
*      ** *     *   * * *
*             **  *  *  *
*    * ** **** E* **    *
*************************