18 12
************
*   *      *
** *  *  P *
*  * ***  **
**     * * *
* *    * ***
*    *  *  *
* * *      *
*   ** *   *
* *  ****  *
*          *
** *     * *
*     * * **
* K***   E *
*****      *
**    *   **
*    *   * *
************