16 18
******************
*   * * *   *  * *
*     *      **  *
**  *      K*    *
* * * *   *****  *
**  *            *
*      ***   *  **
* *  **  *    * **
*  *     *   * * *
*   * *     ** E *
* *  *   ***   ***
**      *** *    *
***     * *    * *
*    * ***      P*
*       *   **** *
******************