19 23
***********************
*** * *  *  * *    ** *
*     * **      *   * *
*** **    *  *        *
*  E *   **     **   **
***   ***  **     *  **
*   *  *   *      *   *
*             **    ***
**   *     *  * ***   *
***      *** *   K   **
**   *  **           **
*  ** ** *    *      **
***   *   *    * *    *
* *    *  * *         *
*     ** **P   *    * *
* *    *   *    * *   *
**            *    ** *
*** ** *   *     *    *
***********************