12 29
*****************************
*   *   ** **  *  **   ***  *
* * ** *    **   *     *    *
*** * * *         *  * **   *
*   *  *    *   *  *       **
*    *       *      **   ** *
*  * K *           **   *  **
*       **  P *       *     *
* **E *   *   * *  *  **   **
*     **    ***         *   *
** * * *   * *  *      **   *
*****************************