30 29
*****************************
*        *    **            *
*    * * * *    * *         *
* *    ** **          * *****
* **E  * * *        **      *
** ** *    *   *   *  * *   *
*           * *    * *      *
*   *       *        ***    *
**      *** **  *****       *
***   **    **   *   *    * *
*     *  *      **  *       *
*      *  *       *   * *   *
*   ** *  ***     **        *
*  **      *  * **  *       *
* *        ** *  *    ** P **
*  * *   *K*    **        * *
* *   * * **   *          * *
*    *  * * *           *   *
* * ** *     * **  * * *  * *
*          **      *    **  *
*    **      *     *  *     *
*      *  *  *   * ** *  ** *
****** * *   ** **     *    *
* ***  * *  * *     **    ***
*  *    ***   *        *  ***
* *   *  **    * *  *   * ***
****     ** **   *   *     **
*        *   *  *     *   * *
*   *      *  *   *   ** * **
*****************************