20 20
********************
**      *        * *
*                * *
**  * * ****   *   *
*  *   *E *    *  **
* P   **   * ***** *
* **  *    * *  ****
*     *          * *
*  *          *   **
* ***  * * *     * *
*      * *         *
** **        *   * *
**       *  * **   *
***     **    *  * *
* **  *  **** *    *
*  *K*  * *  *  *  *
*   *          **  *
* ***  **    * **  *
*     * *     * *  *
********************