29 15
***************
***     ***  **
*  *       *  *
**   *   *  * *
*  *       *  *
*        * *  *
* * ** *     **
** *      * ***
*   **  ***** *
*  *  *      **
**        * * *
*    **       *
* *  *   * *  *
***   * *     *
**  ***     * *
*  *     * E* *
**      * * ***
*  * * *      *
**         * **
*   **  *    **
*   *  ***    *
*     *   * * *
*  *        *P*
***   * **   **
*    **       *
*   * ***     *
*  **        **
*      *  K * *
***************