19 19
*******************
*            ** ***
*    **  **     * *
* * P** *      *  *
*   * ** *       **
***           *   *
**             *  *
* *  **      *    *
*    * ***   *   **
*  **   *     *** *
*   **  **  *    **
*  * **    **     *
*  * *    ** * ** *
*    *     K * *  *
* *  *      ***  **
*   *E** * ****   *
*       **  *  *  *
*  * *  *  **     *
*******************