17 23
***********************
*  ***       * *      *
* *   *  **P *   **  **
*  **    * *      **  *
*   *****   * *** *   *
* ** * **      *    * *
*     **   *     *  * *
*     * *    *     ****
*  *     **    *   *  *
*    *   *     K E    *
**  *         *   **  *
*   **  * *   * *     *
* *        *    *  *  *
**    **  * *     *** *
*   *  ***    ** * *  *
**  *    *      *     *
***********************