16 23
***********************
** *   **      *  ** **
*            *    *  **
*** * *   *    *  E   *
*  *  *    * K      ***
*   ** ** *  *     * **
**    * *  *   * *  ***
**                 ****
**  *  ***   **   *   *
* **P           *     *
**          **    **  *
* *** * *     *    *  *
*****   * * *   * * * *
**      *   ** *      *
** *          *    ** *
***********************