20 20
********************
* *  *  ****   * * *
*    *    * **** ***
*  ***** *     *   *
*    *    *   K*****
* *     *          *
*  *    ** **  ** **
*  * * * E*   * *  *
* * **    *   * *  *
** *            *  *
*    *     **P   * *
* *       * *   *  *
**               * *
*   *  **          *
*            **    *
*   **     *   *   *
**      *        * *
*         *  **    *
**** *   *        **
********************