17 20
********************
*   ** *  * ***   **
***   **    *   ** *
**P    *   *       *
* *   *  *  *   *  *
**                 *
*  *   ***    ***  *
*  **   **   E *   *
** K   **   *** * **
* * *    *     * * *
* * * * **         *
*      *  *  * **  *
*   *      *   *   *
*    ***       * * *
*  * * *           *
*    *     *   *   *
********************