26 13
*************
****     *  *
* *     ** **
** *   *    *
*  *  *    **
*      *  * *
*    *      *
**        ***
*   **  *   *
*     **    *
*   * * *****
*  * **    **
*   **  * * *
* *     * * *
*   *       *
***     *   *
*     ***K* *
*   ** *    *
*    *  * * *
* ** *  *  **
** *        *
*           *
* E *  * ** *
*    **   ***
*    *  *P  *
*************