13 32
********************************
*   E  *  *    P*    * ***  *  *
*  ***       *     *** **  *** *
*   **    * *    ***   *  ******
*   *  *        ***   * *   *  *
*   ***  *    **           **  *
*  * *               * *     * *
*  *      *   *  *             *
*           *         *  *  *  *
* *    *    ** **    *     *  **
**      * *   *     * *     *  *
*K*         **  *      *      **
********************************