12 13
*************
*       *  **
*  *  ** * **
*  *  *  * **
* *        **
*E*   * K*  *
*  *    *****
*      *    *
*      * * **
*     P *   *
**       *  *
*************