12 20
********************
* *  E   ** * * *  *
* **  **  *   *   **
* *       K  P*    *
* *     *    ** *  *
*        **   *    *
*  * **    *    *  *
*    *     *       *
*  *   ***  *   *  *
*   * *  * *    *  *
*       * *      * *
********************