14 31
*******************************
* *   *  **    *   **    *    *
* E*    *  * *    *  *  * * * *
** *  *   * *  *            ***
* *   * *      *     **  *  ***
*    *     * *     *     *    *
*  **  ** *      * * * *    * *
**       * *    *     *     ***
* **     ***    *  * **      **
** * *   *    *       ***    **
***   *   * *  *   K *   *   **
*   *    *    *** *     ***  **
*  P* **     * * *      **  * *
*******************************