25 13
*************
* ***     * *
*     *     *
* ****    * *
* * **     **
*   ** *    *
* **       P*
***      ** *
*      * * **
* **      ***
*     * * * *
* *   *    **
*   ** ***  *
* *** *K   **
*E*    * ** *
*  *   ** * *
* ** *  *   *
*  **   *   *
*   *       *
*   *    * **
*** *      **
**   *      *
*    *     **
*  *    *   *
*************