12 21
*********************
*         *  *  *** *
*    * **      **   *
**   *  * *   *     *
*  *       *    * * *
*  * *  * * *       *
*  **  * *  ***    **
***  *  E **    **  *
*       *   K  * * **
*     **    * **    *
*          **  **P  *
*********************