24 16
****************
* **      * *  *
*  * E   *   ***
* *** *** **** *
*  *    *      *
*     ** **    *
*    *       * *
*  *  ** ** *  *
*        * *   *
*    * *   *   *
** *   ** *    *
**     *    *  *
**K*           *
*    ** *   *  *
*  ***  **   ***
***    * * **  *
*              *
* *  *       * *
** *     ***   *
* * **   ** *  *
*          * P *
**     *     ***
*  **   *  *   *
****************