12 28
****************************
*   * * *   **  **  *  *   *
**       *    *            *
*K**    *** * * *   *   *  *
**     *       E       * ***
**    * *  *     *  * * * **
*    * P  *  *   *  *      *
*         *  ** * * *   * **
*          **    *  ** *  **
**    **      * **       * *
*      * ** **      *    * *
****************************