12 19
*******************
* **   *    *     *
*** *   *  *** *  *
*  * *     * ** * *
* *       ****    *
**    *           *
*   * * *    *    *
** K*     P *  * **
*  * *       **   *
*  E     *  ** *  *
*    * *  *  *   **
*******************