30 14
**************
***       *  *
*      *   * *
**   *  *    *
* *  * * *   *
****   *  ****
** *       * *
* *      * * *
*      * *  P*
**   *       *
*   *    *   *
*   *  *     *
*      K *** *
* **   *    **
**          **
* **   *     *
*     * **   *
** *   * *   *
*         * E*
****   *    **
* * * *  **  *
*  *         *
**  ***  *   *
*   *  *  *  *
* ****  * *  *
**  *     * **
* * **       *
**   ** *  * *
**  * * *  * *
**************