30 13
*************
* *  * *    *
**   **     *
***      K  *
*  **  **  **
* **  *  ** *
*     *    **
**   *      *
*    *     **
* *         *
**    **   **
*          **
*    **   ***
*  *        *
*        P E*
* *  **     *
*    ***    *
* *      * **
* *    *  * *
*   *  *    *
*  *  **  * *
*** * **   **
***  ** * * *
** *  **    *
** *   *    *
** *  *    **
* * *  **   *
** *        *
* *      ** *
*************