13 30
******************************
* *   *  **  **  *  **       *
**   *      *     * **    *  *
*    *  * *    * * * *    *  *
* * **     *    *  *        **
*    *     * **   *  *     ***
*  * *  ***    *      E ***  *
* ****** **   *    * ***     *
*  *  *K            *  * * * *
*  *   * ***  *              *
*    *      *   *    *    P  *
**  *   ** *  * ***          *
******************************