12 30
******************************
** E  ** ** **    *      *  **
** *    * *    *   *  *    * *
*   *   *  **             *  *
**   * *            * ** *   *
*  ** *  **           * **   *
*        ** **  *   * *      *
*   *   *  *****   P * * * * *
*     *     *   **  **  *   **
** *            *      *   * *
**  **       *   ** K    **  *
******************************