15 27
***************************
* * **        *  *   *  ***
*   *  *      *** * * **  *
* *  **   *P *   * * *   **
***  * *   *   * *    ** **
*   **       *  ** *  * * *
* *     *   **         ** *
*  *        **   *      * *
*  **   *       ** E    * *
*     * *    *         * **
*       K    **     *   * *
*  ***   *  *   *      *  *
* **  *        *    * * * *
* *** * *      * *  **    *
***************************