17 12
************
** *     * *
*      * * *
**         *
**    * *  *
***  * *   *
*P  ***    *
*  * *  *  *
*     *E   *
*      *   *
*     *   **
**   *  ****
**      *  *
*  *  ** K**
**     *   *
* *  * *   *
************