27 14
**************
* *    *    **
**   ***    **
** K* *  *   *
*    * ***   *
*            *
*     ***    *
*   E        *
**  * ***  ***
* **     *  **
* *  **   *  *
* * ** *     *
*  *    * *  *
** *         *
*  * ***     *
*    * *   * *
**         * *
*           **
** * **  * * *
* * *  *    **
*       **   *
*P * *       *
* * *** ** * *
* * * *    * *
*           **
*  **     *  *
**************