14 30
******************************
**    *  ** *     *  *       *
* *          *   **        * *
*       *  *   **          ***
** * * **   **    **    ** * *
*  *  ** * *       *** * *   *
*       * * * * **P* ** *  ***
*          * *             E *
**    **  *  * *   * *       *
*        *     **            *
* *      ***  K   *   * ** * *
*    *        ** * *  *   *  *
*  *   ** *     *     *  * ***
******************************