15 25
*************************
**      *E *   **      **
** ** **   **   *  *    *
**  ** * **     **  * ***
*  *     *              *
* * *   *     *        **
*         * * *         *
*   ***    *    *   *   *
**    *    *   *  **    *
*   **  ****        *   *
* K* P* **      *   **  *
*  *   *   ** *      *  *
**      *    *   * * ****
* *      * **  * ***   **
*************************