26 13
*************
***E*       *
*    *     **
*    * *    *
**          *
**     **  **
*     **    *
*       **  *
* *   **   **
* * **  *   *
*      * *  *
**  *  *  * *
*  *  *K    *
*    * ***  *
**  ***    **
*         * *
** P        *
*    *      *
*    *    * *
**   ***   **
*           *
*   * * *** *
*    * ** * *
**** *   *  *
*    * * * **
*************