18 20
********************
*   *   *     * *  *
*    K  *         **
* *  **** *  **  * *
* ** *   ***       *
***    *   *      **
*  *     **    * * *
*    **      * ***E*
*   * *       *  * *
* *** *            *
**  *     **   *  **
* **           **  *
*     *    *  *   **
** * **  * **** *  *
** **   *   *  P * *
* *  *   ** ** *   *
*  *             * *
********************