18 15
***************
* *      **  **
*  *    K   E**
**          * *
*  *     * * **
*           * *
*  *    P* * **
* ** *        *
**      *******
** ***  ***  **
*             *
* *** *    *  *
*  ***      ***
*   **   * *  *
*  * *     *  *
**   ***     **
**    *  * *  *
***************