22 15
***************
*  *  *    * **
**  *        **
* * * K  *   **
* ** * *   * **
**        **  *
*  **  E     **
*      *    * *
*       * *** *
* * *   **    *
*   *** * *   *
*  * *  *     *
*  *        * *
**P          **
** *   * **  **
***  *     ** *
*  *   * **   *
*       *     *
*  *  *       *
*      ** *   *
*       *   ***
***************