13 26
**************************
* *     **     * * *    **
*  **   * *     **   *   *
***   **   *      *K *  **
* *   *                ***
* **      *    **** *  *P*
*  * *                   *
*    ** *   * ***     *  *
****    * * ****   *     *
*  * * **      E  *      *
*         * *  **     ** *
*    * **   *  *     * * *
**************************