30 12
************
** * *  * **
**   *     *
*    *     *
*  *     ***
** *   **  *
*       ** *
*   *   * **
*  *      **
*        * *
* ** E*  * *
*       * **
* * *  *   *
*** *** *  *
*      *   *
*   *****  *
** *       *
*  *K     **
*  * *    **
* ****     *
* *    *   *
**   * *  **
*  * *     *
*  *       *
*    *   ***
**       *P*
*  *    *  *
* *   **   *
*   **** * *
************