14 21
*********************
*  *  *    K  ** * **
*   *        *     **
**  **** * *   * *  *
*  *         *      *
** * * *  ***     P**
* * *    *  *       *
*    ** *  *        *
*  *  **     *  * * *
**     *   E**     **
*  *  * *  ** *     *
**      ***    *    *
* * *   *  *    *   *
*********************