13 21
*********************
*     * **   **     *
*    ** **      **  *
**              *   *
*  *    * *   * * ***
* *    *       P    *
*   *  **  K  * *   *
* *  *    *         *
* *** * *    ****  **
**  *     **   *  * *
* * * *   * *   *   *
*   *  E  **  ***  **
*********************