29 14
**************
*  *   *** * *
* **  *   ** *
*   *   *    *
**  *K  *  * *
* **         *
* *     * *  *
***   *     **
*         * **
** **    *   *
*  *     *   *
*           **
*  * * *E    *
*   *  ** * **
**  ** P  *  *
** * *    *  *
** *         *
* ****     * *
* ** ** *    *
**  * *  *  **
*  *    *  * *
* *     * *  *
*  *       ***
*  **  *     *
* ***    * * *
**           *
**      *    *
* *        * *
**************