19 14
**************
*** **      **
* K *  *     *
**   *  *    *
*   *      * *
*   * * *   **
*        *** *
*  **       **
* *   ** * ***
* ***  *   ***
* ****      **
**           *
*  *   *   * *
**         * *
*  * *    *  *
***    E  *  *
**   * * P*  *
**    *   *  *
**************