22 17
*****************
*** * * *      **
*  **  ***      *
*  ***  *       *
***  ***   *    *
* ** *     ** * *
**      *      **
*         *   ***
*       *    * **
*  *   *    **  *
*  * *       *  *
* *  **       ***
*   *  * *    * *
*  * *P  **   * *
*   *     *   * *
*   * * * **    *
* *     *K *   **
*     * *  * ****
*  *  ***      **
* ***      *  * *
****     E      *
*****************