22 14
**************
*       ** * *
*   *  ** * **
**  * *      *
* *          *
** **K  *    *
**     *     *
***  *   * P *
* * *  * *   *
*  *** * E*  *
*   **      **
*   * * *   **
*        *  **
*         *  *
* ***   * *  *
**      ** * *
***   *    * *
*        **  *
*    *     * *
* ***   * *  *
*  **  **  * *
**************