15 13
*************
*  * * *    *
*   * ***   *
*   * *  *  *
* *    **  **
**  ****E*  *
*         * *
*          **
*     *** * *
*P**   *  * *
*  *  *  *  *
*    K      *
*  *        *
* ** *    * *
*************