18 14
**************
**      ** * *
* *   *   * **
**  *      * *
*    ** *   **
*        *   *
*  ***       *
* *    * ** **
*    *  * *  *
* *  K * *** *
*      *  *E *
*  *  *     **
*     **  *  *
*        *  **
*  **P ***   *
**      ** ***
*  * *   *   *
**************