15 25
*************************
* * *       * **  ***   *
**    *   *   **     *  *
****  *        *  *  P  *
*     *** * *    *  * * *
*   **  *      *     *  *
*   *   ** *         ** *
*    *  ** **    * E* ***
*    *        **        *
* * *** **K     *    ** *
**  * ** ***           **
*  ** ** *    * **   ** *
**    *  **        **   *
* *  * *  *****         *
*************************