25 13
*************
*    * *  * *
*  *   *  ***
**  *E  * * *
**  *   *   *
*  * *   *  *
***   *  *  *
*       *   *
*           *
*    *   *  *
* *   *  *  *
** *  * *** *
* * * *  * **
**  *  * * **
* *    *    *
*       ** **
* P*   *    *
*       * * *
***  * *    *
*   * **    *
*   *    *  *
*  **     ***
*   *    ****
*  * **K*   *
*************