24 19
*******************
**    *       **  *
**** * * *  *    **
** *   P **       *
*       *   *   * *
*    *      **    *
**  *   *        **
*   *  * * *  *** *
*  * * * *    * * *
**    *      *    *
**       *   *    *
* **  *    *      *
*  *E* * * *    * *
*       *  **   ***
* *  *    **      *
*      *     *   **
*   ** * *    * ***
***  ** * * **    *
*                 *
**  *  *   * *   **
**  * * *  *     **
*  * ***     **   *
**   ** *     ** K*
*******************