21 20
********************
*    *   * *  **** *
* *   *  **  * **  *
* * *   * *     *  *
*  *  *    *  *    *
*  *        *      *
**      **   *    **
**        **      **
*  ***   *  *   *  *
*         *       **
**P  **  ** **     *
*  *  **    * *    *
***  *       *  ** *
** * *  * * *   ** *
****    * *    *** *
***    ***      E* *
*      * *         *
*            K**   *
*      ** *     *  *
*  *   ***   *    **
********************