18 18
******************
* *    *       * *
**  *    *  *   **
*   **     *     *
*  **     *P *   *
**      *  *  *  *
*  * *     E *   *
**   *  * *     **
*                *
**       *     * *
*  *  *    * * ***
**   *  **  * *  *
*      *  * * ****
* *****    ***  **
**    ****  *   **
*   *K  ****  *  *
*            * * *
******************