25 14
**************
*      *     *
** ** *   ****
* * *    *   *
** * * * *   *
*          * *
* **       * *
*   **       *
*   *  *     *
*   *   *    *
**    *  *** *
*   ** **  ***
*   *   *   **
*   *  **   **
* *  *   * * *
**    *      *
*   *   *   **
*   **   *  **
** **      ***
*    *  **** *
*  * *  P    *
*  *         *
* * **E *   **
*  *  K*  * **
**************