14 22
**********************
*           * **  *  *
*** *  *   * * P*    *
*  *    * *  * *  *  *
*  *    * * E **     *
**  *   *   *   *    *
*      *   ** * *   **
*  *              * **
*   *   ***   *    * *
****      ***     ** *
* *      * *    *    *
* *              * ***
* *   *  K**   *  ** *
**********************