12 12
************
*     **   *
*K  P*   * *
*  ** *  * *
*   **** * *
***   *** **
*    *   E *
*    *   ***
*          *
*        ***
** **     **
************