23 14
**************
*  ** *   * **
* * K ***    *
* * **  *   **
*        *   *
*   *      * *
* *       ****
* E       * **
** *    ** * *
**  * *P *   *
*  *         *
* *     * ** *
** * **  * ***
*   *     * **
**           *
**       **  *
*  * *   *   *
* *          *
*    *      **
**   *  * * **
*      *  *  *
*         *  *
**************