24 25
*************************
**    * * * * *       ***
**  * * *        ** **  *
* *** * * *  * *    ** **
*  *   **   *      *    *
*      *  * * K   *   * *
* **   **    *    *    **
* *   *     *  ***    * *
*       *   *    *   *  *
*  *   *     *         **
**    * *      *  * *   *
**  ** **      *  * **  *
*   **      *     *    **
* *  *                  *
*               * * *  **
*  * *   ** *     ***  **
**** *       *   **     *
* **    * * * *       ***
**     **** *      *  *P*
*  *       *   E*   *   *
*   *  **  **      **   *
*       *     * *  * *  *
**      *   * *  ***** **
*************************