21 16
****************
*   * * ** *  **
*E *   *    *  *
*     ***    ***
*   *    P *  **
* ***  *      **
*  *      * ** *
** * **        *
*    **  * ** **
**   *     * * *
*        *     *
** *           *
*  *        *  *
*  *        K* *
*  ** *      * *
*    **   *    *
*   *  *  **  **
***   ***  *  **
* *       *  ***
*  *        ** *
****************