32 12
************
**  *  *  **
*    **  * *
*   * * ** *
** ***     *
* * K    * *
*         **
**      ** *
** **  * * *
*   * *  ***
*   *     **
*   * *    *
*     ** ***
*** *     **
* **     ***
*         P*
*      *****
**   * * * *
*    *     *
**         *
*  *     ***
*  *  ** * *
** *    ** *
* **   *   *
**        **
* *    *  **
**      *  *
*   **     *
* *        *
** ****    *
*      E*  *
************