21 14
**************
***** P      *
*   * **  *  *
***  * ****  *
*   *        *
*  *        E*
**        * **
*    * *     *
***       *  *
** *  * K* * *
**       **  *
* **   * *   *
**      **   *
*     ***    *
* **    *    *
* * * *     **
*  *   * *   *
*  * *    *  *
*** *  *  * **
*    ** ***  *
**************