13 12
************
*     *  * *
*    ** P* *
* * * *  * *
*       *  *
*     *  * *
**  *      *
**       * *
*       * **
*** ** **  *
**  *   K* *
***E   *   *
************