13 16
****************
* **   *   **  *
*   *  *     * *
*     ***  * * *
*P           * *
**    *        *
**  *  *    *  *
**** * ** * E***
*     **    * **
** *           *
** *  K***  *  *
*   * * *    * *
****************