27 15
***************
*   *   *   * *
*  *         **
*    *    * ***
*   **        *
*       * *   *
*  * **    ** *
**** *  *     *
*  *  *  *    *
*            **
*    ** *** ***
*   *        **
*  *  *   *  **
*   P *   * * *
*     * *   * *
* **  *   *  **
*  *    *    **
**   *   * *  *
*   **  *     *
*     **    * *
*   ***  *   **
*     ****    *
*   *  *   *K *
**      *   * *
*  ** E     * *
*   * * *  *  *
***************