18 14
**************
*  *      *P *
*     K**  * *
* *     *  * *
** * **  *   *
* ** *   *  **
*   *    **  *
*    *    *  *
*      ** ** *
*    **  *  **
*    * E* ** *
*  *  *   *  *
* **   *    **
* *      *** *
*     *  *   *
*     *   *  *
* *      ** **
**************