20 12
************
**  *  * * *
* * **  *  *
*K *    ** *
* ***  *****
*    * **  *
*     *  * *
**         *
*   *      *
*P*    *   *
** * *     *
* * *   * **
*  *  *    *
*E*        *
** *****   *
** *  **   *
*  ** * ** *
*   *    * *
*        * *
************