15 18
******************
*  * *    *     **
*** * *    * P   *
** * **   *    * *
**** **          *
* *    *  *   *  *
*    K   *    * **
* *  *           *
* *    *         *
* * *  *     *   *
**   *  *      * *
***  *    *      *
* E*       ** * **
* **   ***   ** **
******************