15 22
**********************
*        *   *   * ***
*** * *      *  *    *
*  *     *   P  *   **
**  *  ** *    K **  *
*       *     *      *
* *** *  **    ***  **
*   *   *   *    **  *
*   **     ***       *
* * *  * **    **   **
* ** *    *  * *     *
*   *     * * *     **
*    * *  * ** *E**  *
*          **   * *  *
**********************