30 22
**********************
**       *   *   *****
*    * * **       *  *
* *     *  ** *   *  *
*  **       P  * *  **
*    * **       *   **
* *  *  ***   E  *   *
*    *   * * *       *
**   *  *  *  *    ***
**   **    *  ** * ***
**     **        **  *
*    *   * **  *    **
*              *     *
* *     ** *      * **
*       **        *  *
*         *   **  *  *
*    *  * ** ** *    *
*  *  *      *     ***
** * *  *   * *** * **
* *  *    ** **  *   *
*    *      *    * ***
*             *    * *
**   *   *   *       *
*       *** **      **
*  **       K    *   *
*  *    * * * * *** **
**     *** **   * ****
** *   * *   *       *
*   ******      ***  *
**********************