18 12
************
**  **     *
*   *****E**
* * *  * * *
*   K *    *
* *    * * *
*      ** **
*          *
** *    *  *
* *      ***
**       ***
***P **    *
*  * *     *
* * *  *   *
***    *** *
* *    *   *
* *        *
************