30 12
************
**   *  ****
*  *   *   *
*K        **
**** * *  **
*    *   * *
*      *  **
* *   ** * *
* ** *     *
*       *  *
*      *** *
*    *  *  *
**   *     *
*    ***   *
*         **
** **  **  *
*    *   ***
**       * *
*  ** *    *
*    *  *  *
*  ** E ** *
*    **    *
**     *   *
*    *  *  *
*   *  *** *
*   **    **
*        * *
*      *   *
* * *** P* *
************