27 13
*************
*   * ****  *
***   ***   *
*   *    *  *
*       **  *
* *     * * *
**    *     *
*      *    *
*        * **
*      * ** *
** *    P   *
** * * *  * *
*  **  * *  *
*    * K    *
**   ** *  **
**    *  *  *
*  *   *  * *
*  ** *  *  *
*  E* *     *
**   *     **
**       *  *
*         * *
** *  **   **
*     *    **
*    *     **
*  ** ***   *
*************