15 26
**************************
**           *  *     *  *
**       **  *     *  ** *
*** * ***   *   * *      *
*   *  **  *  *  *       *
**  ** **            * * *
**    *  *   *  * * *   **
** *      * *  *P*   * E**
*    K    * * **        **
*  ***    *   **    **   *
*       * *      *      **
* *   *  ** *         ** *
***       * *  *  * *** **
*           *  *   *     *
**************************