12 16
****************
*  * *     *  **
* *  *  **  *  *
*         *  ***
* *     *    P *
*  **  **   *  *
*     K        *
*   * *   * E* *
* * *    ***   *
*  **  ***   * *
** *  **       *
****************