22 16
****************
***  ** *      *
*  ** **   K * *
*         *    *
*     * *      *
* ** E  **  *  *
**P     * * *  *
* *  *  ****** *
* ** **     ** *
*   *      * ***
******      ****
*      *  *   **
* ** *         *
* *     *      *
**   * *    *  *
**     ***    **
* ***    *  *  *
**   *  **     *
* *  * * *     *
*   *     *    *
** *    *    * *
****************