23 12
************
*    * * * *
**     ** **
*      ** **
* * **   * *
*    *  *K**
*    *    E*
* **** P   *
** * **  * *
* *        *
*****      *
*          *
** *   *   *
***    *  **
*  ** **  **
*        ***
***  * *   *
*   *      *
* *      * *
***  *    **
*  *   *  **
*         **
************