12 26
**************************
*   *  *       *  *  *  **
*    *     *  *      *   *
* *       *     * *      *
**    ***  * * E*       **
*    *       *  * *   *  *
* *  * P* *     ** * *  **
*** *     ***   * ***   **
*    * *  ***     **    **
** *   *    *  K* * *    *
*         * *     * * *  *
**************************