13 32
********************************
**  *   **   *   *         **  *
*      **    *       *    *  * *
*      ** *       *    **      *
*  *  *  *   *  ***       *  * *
**  * **** *  **  *    *       *
*  * **  * **      *  *  ** *  *
**      * *    *  P    *       *
** *   **  **    E   *   *  *  *
** *  *  *    * **       **    *
** * * *    *   ***      * *K **
* *  ***      * ** **  ** *    *
********************************