13 16
****************
*  *  ** * E * *
** *      **   *
**  *         **
*   *** *    * *
*  **    * *   *
**   *   * **  *
*    * **      *
**   *  *   *  *
* *    **  *  **
*     * *      *
*  *  K**    P *
****************