13 23
***********************
**     *    * *  ** * *
****     *    *  * *  *
*   * E   *   *  **** *
*  *   * * *      * * *
*                    **
*   * ** *  *       *K*
**    *      *       **
*  ** * * * *   * *  **
** **     *  **      **
**       * **    *    *
* *    * *   P*  **   *
***********************