15 12
************
**       E *
*** *   *  *
**      P* *
**     *   *
*          *
*     *    *
***    *  **
* *     *  *
* *  K **  *
**    * ** *
* *     ****
***  *   * *
***   **   *
************