19 29
*****************************
*E *     **   *  **        **
*     *      * * *     ***  *
***    *   **     **     *  *
*     ***                   *
* *       *    *       ** * *
*        **      **   *     *
*       * *    **  * *  *** *
*   *  ** **  * *    *   *  *
*    * **   * P   **        *
**    * *** *             * *
* *  **      *  *   * *   * *
*    *     *** **  *    ** **
*    *     * **     **    * *
*  ***  *       *       K****
*      *  **     * *  *    **
** ** **       * *     ** * *
*  **   *   **  * **  ***   *
*****************************