22 16
****************
*            * *
***  * * * *   *
* *          * *
* *     * *    *
** *  * ***    *
*  *           *
*  *    * * *  *
*   *   *  **  *
** *     *   * *
* *  K* *  **  *
* **P****  ** **
*    *       E *
*  ** *  *     *
* ** *     ** **
** * **  * **  *
**   *   *   * *
* * *   **   ***
*          *****
*              *
** *      *    *
****************