12 13
*************
*  *    *  **
*   *   * * *
*  *        *
* *** * *P  *
*      *    *
**   K*     *
*E  **     **
**  **   ****
*      *   **
*     * *  **
*************