18 22
**********************
**** *   * *   * *   *
*    *  *       ** * *
*  **                *
*    * **       *   **
*  *   *   *       * *
*E***    *  * ** *   *
* *          **   *  *
**  **  *  *   K * * *
* *P  **       *    **
* *  *      *        *
* *      *** * *  *  *
* *        ** *     **
*     *   *     **  **
*      *  * *     ** *
*   *  **  * * *     *
*     *    * ** * * **
**********************