12 22
**********************
**  *      *   **    *
*  *       **  *** * *
*     **     *** *   *
*   * * P      *     *
*    *E**     **     *
* ***      **   *  ***
*K*        *      ****
***    *     *  * *  *
**     ** *  *    *  *
* ** * *       *   * *
**********************