22 19
*******************
*       **    **  *
*            *    *
**** ***    **   **
* ** ** *  **  ** *
* *      *  *   * *
*  *    *  *  * ***
* **  P           *
* *     ***       *
*     *  *   * *E *
**   *  * **      *
**        *   *  **
*            *    *
* *     *   * * ***
** *  *  *    *****
* ** **       *  **
*  *** *   *     **
** *  *           *
*      *   ****   *
*    ***  * *     *
*     *K    *    **
*******************