24 18
******************
*         *  *** *
* *  *    **    **
*** *        *   *
*   * *  ** *   **
***  * **   *    *
*  * *   *       *
* *   *    * * * *
**    *   * ** * *
**  * * ***   * **
** *      *    * *
* *  * *     *  **
* *** ****     * *
**        *      *
*      P*   *** **
**   ***     **  *
**   **    ** *  *
* *  *  * * *   **
*        *  ** * *
*    K  *        *
* E *   *   *    *
* *  **  **      *
*   * *  **      *
******************