32 13
*************
**   *  *   *
*   *  *    *
** * *  **  *
*   *  **   *
*       *   *
*    *    * *
****    *   *
*  *   *   **
**  *    ** *
*           *
*    *  *   *
**     *   **
***     P * *
*      **  **
*    *    ***
***    **   *
*   *       *
* *    *   **
**E*  **    *
*   ***   K**
*    * * *  *
****        *
**  ** *   **
* *   *    **
*   **    * *
*       *   *
*  * **     *
*     ***  **
*     *   * *
**  **  **  *
*************