15 20
********************
*   *  ****        *
*   * **  **     * *
* *       *     * **
*  *      E  *  ** *
** * **  *    * *  *
*     **     *    **
* * *   **  P    ***
* *  * *         K *
* **** *   **   *  *
* *   *          * *
*         *  *     *
*  **   *       *  *
*     *   ** **** **
********************