18 21
*********************
*   *  **         K**
***   **     *  *   *
*  **   *       * * *
*   *     ****    * *
**        *    **   *
**  * **    * ***** *
*** * *         *  **
*  * ***  *   * *  **
*   *     *      *  *
*     *  *   *  *   *
*     ** **       * *
*** ***      * *   **
* E  ***   *  P *  **
*             *  ** *
**     *      *  ** *
**           *  ** **
*********************