13 32
********************************
**  *     *      *  **   * *   *
* *   **         ** * *  *    **
* * **  * *     * ** * **      *
*      * *      **  *       *  *
**K *P            *   *  *  ** *
* *         * *   *   *        *
* *     * **    *  **   *    * *
* *   *   *  ****   E*      *  *
*  *    * *  *  * ** *      *  *
**      *  **   *  * ***      **
*    *        **  *   *    *   *
********************************