12 16
****************
*K      *  * * *
*             **
*   **    P* * *
*  *        E* *
***      *     *
*   * *   *   **
* *    ***    **
* *   * *  *   *
*   *  **  *** *
***     ** *   *
****************