13 32
********************************
*   * **  *  *  ** *   * ** *  *
*             *  ***         * *
*       ** *** **  *E **   *   *
* *    * ******     *  * ** *  *
*  * *  *       **  *          *
* ** **    *           * * *   *
*  ***   *   * *    ***        *
*       ****   *K      **      *
*P           *  ** *    *      *
*   ****    *  * *  *          *
*  * *        *  *  *    * *   *
********************************