15 28
****************************
***** *       *  *** * *   *
* *   *  *         ***     *
*   *  *        ** * **  * *
*    *   *          **  ** *
*     *  *     *    *  * * *
***              **  **  * *
*    *  * ****         *  **
* *       ***    K * *     *
*   * **    **  *    **    *
** ***   E   **            *
**  * * *       * * *  *   *
*   ** P* * *   **  *   *  *
*   *   *  **   *      *  **
****************************