19 21
*********************
***** ****          *
*    *        * *   *
*               *   *
**       P  *    *  *
***    *   * **    **
** *     * *    * * *
*  *  * * * **  * * *
*** *   *   *    *  *
**  *     *   *  ** *
** ***       *    ***
* *     *****   **  *
* *     **   *      *
*     *      *   ** *
* *  *  *  **       *
* * * *** *        **
*   *   *    K*  *  *
**    *      *E     *
*********************