30 13
*************
*     **  * *
** *** **   *
*    *      *
* *         *
*     *     *
*** * *  *  *
*   ***   * *
*        *  *
*   * ** ** *
*           *
***   *   K**
**   **** E**
***    *  ***
*     **    *
*  **     * *
* **        *
*        *  *
*    *  *   *
*  *   P   **
*        *  *
* ***  ***  *
* * *   * * *
*  * * *   **
*     * *  **
* *** *     *
***  * * *  *
*       *   *
* *   *  * **
*************