17 18
******************
**       *       *
*    **   *E     *
** *  **   **    *
* *   * *  ** *  *
**** *   *      **
**     ***   *  **
*  *  P       * **
*    **  *  *    *
**       *  *   **
*   *    ****    *
* *  *    ***   **
**   *        * **
**   *   *       *
***    *    *K   *
*     ***  **   **
******************