12 29
*****************************
**     *   *** * *  ***     *
*        *       *   *   ** *
*          ****       *   * *
***   *   * *       * *  *  *
***      ***   *** ****     *
*   **  ** * *     **    *  *
*     *  *  **    *   ***   *
**  *     *  * *    *  *   **
*   *P *     * K*  * * *  * *
*  * E     * *   **    *   **
*****************************