15 30
******************************
*     *       **  *   *  **  *
*    ** ** *   *   * *      **
* *    *  **     * *  * ***  *
**      *   K * ** * ** *    *
*      * ** * **  * ** * * * *
*    *   **       *   *  * ***
*   *     **     E       *   *
** ***  *            ** **   *
*       P    ***   * *      **
* *           **      ***    *
* * *   *  **      * *  *    *
*       **   *    *  *  * ** *
**  *          *  *  *  **** *
******************************