12 27
***************************
***     **     * *  ***   *
*  * *  *** *  * * * **   *
*    *   ** *  *P*       **
*      ** *          *   **
*  *     * *  *   *       *
*  **  *    *  **     **  *
* *    K   ** * **  *     *
*    ** ** *        *   * *
*      *        * *  * *  *
*  **    E      **   **  **
***************************