15 28
****************************
*    * E*   *  ** *  *     *
**  ** *  *      **        *
**    *  *  **   * *    ** *
*   **    * *   *   * **** *
*     *   *   ***    *    **
** K** ** **    *   **  *  *
*  *    * *  * *  *    **  *
* *   *     *          *** *
**      *      *** *   * * *
*    *              *  **  *
***       ** ****   *      *
* * *          ****   * P **
* * *         **  *        *
****************************