22 13
*************
*  *   *  * *
** * ** *   *
**   K      *
*           *
* *      ** *
*          **
*  ***      *
*  * *P     *
** *  *** ***
***   * **  *
* * **   *  *
*       **  *
*   ****    *
* *    ***  *
*   *  *    *
** *   *   E*
* ***     * *
*   * *  ** *
*  * * * *  *
**    *     *
*************