15 14
**************
*P **  * *   *
**       ** **
*    * *     *
* *       ** *
*        **  *
*    * **K  **
* ***    * * *
* * *       **
*  **  *    E*
* * *  * *   *
*    *    *  *
*          * *
**     *  ** *
**************