13 15
***************
***    *    * *
* *           *
***  * *      *
*      *    * *
*   *     *   *
****          *
*  *  * *   * *
** *   * *    *
**  *   ***   *
*    *   ***  *
* K P*       E*
***************