20 14
**************
*   *  * *  **
***  K   **  *
*     P*  *  *
* **     * * *
*    *     * *
**           *
***   *      *
*   *        *
* **     ** **
*  *   **    *
**** *   **  *
*   *     *  *
*   *   E *  *
**  * * *    *
*  ** *  ** **
* *  *       *
***     *  * *
**  * **     *
**************