16 15
***************
*       *    **
* ** *  * * * *
*      ** *   *
*   * ** * K  *
*   *     *   *
* *    *  **  *
*          ** *
*       *    E*
*  * **  ** * *
** *   * * ** *
*      **   * *
*  ***    *P* *
*      *     **
*      *  *   *
***************