14 14
**************
** *         *
** ** *  *   *
***  * * *   *
*    ** * * **
*  *   * *   *
**  *     *  *
*    K* **   *
***  *       *
*     E      *
*   ***      *
*P    **   * *
*    *  *  * *
**************