20 12
************
**      *  *
*   * *   **
**    ******
*       ** *
*          *
* *    *   *
*   * *  ***
*    *     *
*   *      *
*      **  *
**     P   *
*   *    ***
*** **E*   *
*  *     ***
*  *    ** *
** *    ** *
*  * ** * **
*     ***K *
************