20 21
*********************
*   **   *       ****
*   ** * * * * *    *
**   **     *   **  *
*   *  *  *         *
** * **  *          *
* P*   *     *      *
* *   **   **       *
*  *  *  *    *   * *
*  **     *   *E    *
*    * *  * *  *** **
**   * ***    *     *
* *           *   * *
*   *       *   * * *
*    ** K**** *  *  *
*  *   *     **** * *
*     * *    * * *  *
**    * *  **  *  * *
**       **    * *  *
*********************