24 17
*****************
*  *           **
**     * *      *
*  * * **       *
*E *  ** **   ***
*  **   *    ** *
*      *  * **  *
*   *     * *  **
*        **  *  *
*  * *    *  ** *
*  **       * ***
*      *   *    *
*       * **  * *
****    *       *
**    *** *     *
*   *    *  **  *
*** *   P   *  **
*   *    **     *
****   * *   K  *
*  ***  *****   *
*  *       * ** *
**     *       **
*  ** *    *    *
*****************