22 30
******************************
*  *  ***  **           *  ***
*   * *     * *   ** *  *    *
*  **          * **     * *  *
*    **  *    *        *   *E*
*  *     ***    *   * ** *   *
* *  * *   ** *    * **  *   *
*    **         **    * *   **
*   * *          *  * *    * *
**        * **      ** * *   *
*  *       *  *  *    *  *   *
* *     **        *      *   *
*  * * * * ** *     * * *    *
**  ** **  * ** *  *        **
*  *                *   *   **
*         *  **   **    *    *
*  * * *   *     * *         *
* P  *   *      **   **      *
*  * ***  *  * * **  * * * * *
*    *  * *   *  *  *** ** * *
*K     *      **** *  *   *  *
******************************