13 12
************
**   *   * *
*E**  *    *
* * K   * **
*  *  **   *
*      * * *
* *     ** *
*   *P     *
*  * *  *  *
*    * ** **
*  *    * **
*   **   * *
************