29 14
**************
*      *** * *
*    **   ** *
*     **    **
**   **    * *
*       * *  *
** *        **
*     *  *   *
*      ** ** *
* ****  *  * *
**   *    * **
*  * * *     *
* ***   * *  *
* * **    ** *
**** **   *E *
*  *         *
*         *  *
* *          *
** *   *  *  *
* **  *      *
*   *      ***
***   *    * *
* ***   P  * *
* *   *  *   *
* *   K  *   *
*        *   *
**  * * *    *
** *    ** * *
**************