12 20
********************
*    P        * ** *
* *      *    *    *
*  ****      *  *  *
* *         * ** ***
** *  *** *   *    *
* ***   *    **    *
* *  **    *       *
*   ** *       *  **
*    *        * K* *
**  *** E   * **  **
********************