16 16
****************
*   * * *  *   *
***    **    ***
*  ***  *      *
*    E* ** *   *
* **      *  * *
** *    *   * **
* *    *  * ** *
* *         * K*
* * * * *      *
* * *    **    *
** * *   *     *
** **   *     **
*  *        ** *
* P*  *   *   **
****************