29 12
************
* *  *  *  *
* * *  * * *
**  **   * *
**       * *
*  *     * *
*K      *  *
** * ** *  *
** *  *    *
*   **   ***
*          *
*   *  *  **
*   **  * **
**         *
*   *  * * *
* * ***    *
*     * ** *
**        **
*    *E *  *
*  *       *
*  **  *   *
**** ** *  *
**      ** *
*    *     *
*          *
**     *   *
*    *  ** *
*  P* *   **
************