12 28
****************************
*  *  *      * **        * *
*  *   ***           ***   *
*      * * *      **       *
* *      * *     * *   * * *
* **    * *    ** * *  *   *
*     *     * * *  ** * *  *
* ** *  * *  *     *  *   **
*P     ***  * *E    **    **
*         * *K *   *       *
***    *  *   *    *  *    *
****************************