23 19
*******************
**      P *   * * *
*   **   *  *   * *
* **   *  * **    *
**   *  *        **
*     *          **
*    **          **
** *  *  * *     **
*           *     *
* *   * **** *   **
*   *   * **   E **
*   **  *  *  ** **
*            * ****
*    *   * *  * * *
*     *  ** **    *
*** *   *        **
** K *   * *    * *
**     *   *      *
* * *** *      ****
*         * *** * *
*   *       * *   *
**   *        **  *
*******************