14 30
******************************
* **   *  ****      ***   *  *
* *  * * * *       * *   * * *
*  *   *        *  *   *  ** *
*       **       *       * * *
*E ***      **          **   *
*  **    ***      *  *       *
*  *  ** * *   ***    *   *  *
*  *  *    * *   *    ***  ***
*    *** *    * *   *  *     *
*      *  ****  **        * P*
* *    * *  **         * *  **
*    *           K *       * *
******************************