16 14
**************
* *   *K**  **
*      * *   *
*   *     *  *
* * *      ***
*    *  *  ***
*  *      *  *
**  ** *   ***
*   ***   *  *
*      **  ***
*   **  *  ***
**   *      E*
* *       P **
**    * *    *
*  * *       *
**************