20 22
**********************
**       *    * *  ***
*   **     ** * * ****
*      **   *    *  **
*** *****     **  ****
*   *     *       *  *
*      K  * * **     *
* *   E    *       * *
*  **  *   *   ** ** *
*     * * *    *     *
*     *   *   **   ***
****           *     *
*       *  *   **  * *
* *   * **       **  *
* * *   *   ** **    *
*** *   *     *      *
*       *  P       ***
**    **  *   * * *  *
*    * *  *   *      *
**********************