14 19
*******************
*  K*   ***   *  **
*   *          * **
* *   **   *    ***
** *  * *   **    *
*  *   *  **  *   *
* *   *     *   *E*
*     *     *   * *
* ** P        **  *
** *         *  * *
* *    *   **  *  *
*   **     *    ***
*   **    *  ** * *
*******************