32 13
*************
**     *    *
*     *   * *
**E       * *
*   * ***   *
***    *  ***
**    *** * *
** *  *  P  *
*  ****  *  *
* ** * ***  *
*  *       **
*   ****  * *
*      ***  *
*   * *     *
* **     *  *
**   *    * *
*  ** K*   **
*      *    *
*       *  **
*   **      *
** *    * * *
*  *        *
*     ** *  *
**  *      **
* ***  *** **
*   *   **  *
*  * *  *   *
* *    * *  *
*     **    *
*           *
*   **** ** *
*************