12 17
*****************
** **          **
**  *           *
*P     * *** ** *
* *   *** *  ** *
* *K *   * ***  *
* *      *      *
*  *   *   E    *
** *            *
*   ****  *   * *
* *        * * **
*****************