27 16
****************
**       *    **
*   ** P       *
*  ******* *   *
*** *          *
*    *   *    **
* *        *   *
** **    *     *
* *       ** * *
**  *   *  *** *
* *    * **  * *
*         * *  *
* ** *    * ** *
***   ** ** * **
*  *   * *   ***
* **  * *  K * *
* *  *         *
**   ***       *
*** * *        *
*        *  * **
* *     ** E * *
**     * **    *
** *  **       *
** **          *
*     *   *  * *
*       *    * *
****************