18 24
************************
*       *   ** * *  * **
**     * * * * **      *
* ** E   **   **      **
* * *  ** *        *   *
* *   * *            * *
**** **  *    ** ***  **
* *   * *    * * *     *
*    **   **          **
**K*  *  *  *  * * * * *
* * **     **         **
* ** P         **  *   *
* **   **     *  *  * **
***       *  *  *     **
*** **    *      *    **
*  *         *   **    *
**   *    *       *   **
************************