22 29
*****************************
*    * *    *    *  ***     *
*     *   *                 *
*****   *        **     *   *
**  **  * **   **     * **  *
*** *  * **       * *    ** *
*P* *  * *    * ***   *  * **
***  *  ****   * *   *     **
*  **  *       * ** * * *** *
*   *   * *    *        * * *
*     * **      * * *       *
*    *  *  *     *          *
* *       ***        *K** * *
* *  *     **  ***   * *    *
*     *   * ***             *
* **  *    **  *   *** * *  *
*       E  ** *       *   * *
*    *  * *  *        *     *
* *  *     **       **      *
*   *  *  *     **   *   *  *
*  * * * ****         *   * *
*****************************