20 16
****************
* *        *  **
***    **    P *
*     *    * ***
***   *  * *   *
*E   **  *    **
*   * * *      *
*   * ** **   **
*     *       **
******        **
* K     * *    *
*    *    **   *
**** * *    *  *
*      *    ** *
*   *  ** *   **
**           * *
*  * **  **    *
* *     * *    *
*     * * * *  *
****************