23 14
**************
*  * **      *
*          * *
**           *
***   * *    *
** ***    *  *
*  *  *      *
* * * * *  ***
**           *
*   *  * **  *
*  *   * ** **
**  * *      *
*   *  *  *  *
*  * *      **
*****  ***   *
*E*   *   * **
*   *      * *
*           **
*   * **  P **
*   *K       *
** *        **
*** *        *
**************