13 30
******************************
*  * *     * *     *   *  P **
*    **  *               *****
** * *   *  *   *       *    *
*  * * *              *   ** *
**** *    **   **    *     * *
*     *       ** *  *      * *
* E   *    * *      *  * *   *
*   ** *  *  *    ***    *   *
* **  *   *       **   *     *
* * * *     *   **   *   * ***
**   *  *  **  *K  **     *  *
******************************