17 26
**************************
* *    *      *  *   *   *
** * *   *       *  * *  *
*      *  *   * *      * *
* **     **P    ** * *   *
**  *  *          **   ***
**  *                  * *
*** *  *      * **  ******
***  *    *   *   K   *  *
* ** E**   **            *
*      *   **  *         *
*  * * *       *   * *   *
*          *  *   **  *  *
***    *  ** *     *    **
**      **       * **  ***
*   *   *   *   *      ***
**************************