18 13
*************
* *  *      *
* *  * K * **
* ** * *    *
*  *       **
***         *
*  *       **
* *     * * *
* *   *   ***
* ***  **   *
* ** *  * * *
*    **     *
*    * *   **
* *   E     *
*      *   **
**   **     *
*       P   *
*************