23 19
*******************
*   * *      *  * *
*  * **  ** ** ** *
* *  *  *    ** * *
* * ***   ** *  ***
***   * *     *** *
*       **   * *  *
***   ****      * *
* *          ***  *
* *  * *      E   *
*   ** *    *    **
**    * *   P     *
**** * *        * *
**              * *
*  * K    *** *   *
*      * *     * **
*      * **       *
*   *    * *  *  **
* *         *   * *
*            *  * *
*** *** *         *
**    *  *       **
*******************