17 24
************************
*        *    *      E**
***  *****   *   * * * *
**    *  *             *
* **       *** **    * *
*   *   * *        *  **
* *    **  *    *  * ***
** * *  ***    * *     *
*    *     * *   * *   *
*   *     *      *     *
*     ****   *  * *    *
**     *         * *** *
*  * *P  * **  *  *    *
* * *  *    ***     ****
*    *  *        *   K *
**      *   ***** * *  *
************************