13 12
************
**     *   *
* *  *** * *
*   *    ***
* **  **  **
*     *    *
* *K *  * **
**   *  ** *
***      P *
*  ***     *
**  *  E   *
* *   *    *
************