24 14
**************
*  *  ** *   *
*  * *   **  *
**  *  ***  **
*  *     *   *
** * **      *
*   *  *     *
*     *   *  *
***         **
** *     *   *
** *    *  ***
*  ** * *  E *
* *       *  *
*   *   *  * *
*   * *  * * *
**         * *
* *  *** * * *
*  *  * **   *
*       *    *
* ***   * * **
*  *   *  * K*
* * *       **
*    *  *P*  *
**************