28 13
*************
** **  * * **
*   * E    **
** **** K   *
**     **   *
**     **   *
*     **   **
** **    ** *
*         * *
*** *  *    *
**P**  **   *
*  *      * *
*       * ***
*   *       *
* *    **   *
**   **  ** *
*  * *   *  *
*   * **  * *
*     *     *
*   *     * *
*   *     * *
* *         *
*    *  *****
*****       *
*   *  *    *
* *      * **
*     *  ** *
*************