26 12
************
**         *
** *   **  *
* *    * ***
** * **    *
*          *
* **   *  **
*   ***    *
** P       *
*  *  * *  *
**    *    *
* K  * *  **
**  ***    *
*       *  *
*       ****
*  *       *
* *   **   *
*  *     ***
*          *
*   *   *  *
*     ** * *
*    *  ** *
**   * *  **
** *    *E *
**  * *  * *
************