15 14
**************
*       *** **
**   *      **
*  *  *  * * *
*   *  **    *
* *   **   * *
*   *  *  ** *
**         ***
*       *   **
*  *    ** * *
**   *E*     *
***K**     * *
*  * P       *
* * **  * *  *
**************