16 24
************************
* P  *       ** * ** * *
* * *     **   *    *  *
*  * *  * *  *    **   *
* *** ** *  * **  * * **
*** *     *    **      *
* *  *    ***   **     *
**    * * *  *      *  *
**                   ***
*  *   ** *   * *  * * *
*   *  *      ***   ** *
*  * E*    K*  *       *
*       * *   **    *  *
*  *  **      * *  *  **
*  **          * * *   *
************************