25 14
**************
* *       *  *
* K    **    *
*   *  *     *
*  E*   * *  *
* * *     P **
*** *  * * * *
*   * *  * * *
*       *    *
** * *    *  *
*   *   *    *
**  *   *** **
*        * ***
* *  ***   * *
*  * *  ***  *
*    * * *   *
* *  *     ***
* *  *       *
**  ** **   **
*      * *  **
** ***      **
* *  *      **
* *   ** **  *
*  *  *      *
**************