26 17
*****************
* * **          *
* **     *      *
*    ** ** * *  *
** *  * *  **  **
*    *         **
*****     **    *
*   * * **  **  *
***             *
* **  *   *  * **
**** *  **      *
*  *   * * *  * *
*   *   * *     *
*          **   *
**     *        *
*      *   *  E**
*         **    *
*  * *  *       *
*  *   *  ** *  *
*    *  * K  * **
* * P  * *  ** **
**** * **  *    *
***        **   *
** *       **** *
*  ** *     *   *
*****************