23 18
******************
*     *  * *  ** *
* *     *   * ** *
*P      *  *    **
*     *  *  **** *
** *      * **** *
*         * * *  *
*   *    * * *   *
*    **  * **    *
*  *  ***    * * *
*            *   *
**          *    *
**  *** ** *  * **
*E    ***  *  * **
*     *  *       *
*   ** *         *
* *     **   ** **
*   * * *    * * *
* *  K       *   *
***   **   ****  *
* *    *   *    **
* *    *    *    *
******************