16 26
**************************
**  *     * * * ** **    *
* *  **  **   *  *  ** * *
*              *   *   ***
*         * *   *  * * * *
* *       *   *  *      **
*** **     ***  *       **
** *            *   K*   *
**  **  *    P*  *  *    *
***          * * *  * *  *
***         **    **    **
** *E  *    *     ****   *
* *   *  * **    **      *
*** *        *   * *  *  *
*     *        *  **   * *
**************************