24 29
*****************************
*  *      *      *       * **
**   *    **  *      * *E** *
* **       * **  *   *  *  **
*** *  * * ** * * * *     ***
**                *   * *****
**** *  ** * **       P     *
* **      *     **   *  *** *
* *    *             *      *
* *  *      *  *   *      * *
* **  * *  **   * **        *
* * *    ** *    * *  * *   *
**         **  *        **  *
*   * *  * *  *  **   *   ***
*  *     *     *    *  **   *
**   * **  *  *   * **    * *
**           * * ** *   *   *
*    * **       *       K   *
*            *   * * **   ***
*  *  *  **      ****      **
*** *    ***     *   *   *  *
*   * ***         *    * *  *
*    *    *   **    *       *
*****************************