26 16
****************
* * **  *  *****
* *            *
* *  **   *  * *
**  *   *   *  *
* * **  *  *   *
*   **   *     *
** * **  **  ***
* *** **   ** **
*        *    **
** E  *     *  *
** * *     **  *
**   *      *  *
*   *  *  **   *
*    *     *   *
**  *    *     *
* *  * ***     *
*     P*     * *
*  *   *    *  *
*   *  **   ** *
* *    *      **
*      *     *K*
*  * *      *  *
* **    * *    *
* *   *     * **
****************