13 30
******************************
*  ***        **  *   *    * *
*    *  **  * *   *    *     *
*   **  K     *  **          *
*           ***  * *   *   * *
****    *    *  ***     * *  *
*** **       *      *  *     *
*      *        E     *   *  *
*  *****             *       *
** *    *   * *     * *   ****
*  *  *   *    * *      * * P*
*     *  *** *  ***       ** *
******************************