13 28
****************************
*  *              *  *   * *
* *        *    **         *
**      **  ***** ***      *
**             *** P     * *
*** *    *   **     **     *
*            * *    ** *   *
***   *  E *  *     * *    *
** *   ** *       ** ***   *
**   ** *****      **     **
*   ***  *  K *     * *   **
**    *     *    * *   * * *
****************************