29 14
**************
*   *  * ** **
***    ***   *
**     *  * **
***  *   *  **
**  *       **
*  ***  **   *
* ** * *   * *
*   *   * *  *
**       * ***
*            *
* *  *    ** *
**      * *  *
*  * *  * *  *
*   ** * *   *
*  **  *   * *
*   *    ** **
*     *  E  **
*      ***** *
*  *    *  * *
*K   **   *  *
*  *       ***
*    * * *   *
**   ** *   **
*     *      *
*    P * *   *
* * *    **  *
*         ****
**************