21 17
*****************
*  *  K      *  *
* **      * *   *
**    *        **
*        ***    *
*  *       **   *
**    *  ***    *
** *   * *      *
* *   *         *
*  * * **    ** *
* *     *  **   *
*  ***   **  *  *
* ** * * * E*  **
* ****       *  *
*   *    ***    *
* *    ** *  * **
**     * * *  * *
*   *  *     ** *
* *    ** P**   *
* * *     *    **
*****************