20 15
***************
***  *      * *
*     *    ** *
** * * *      *
*  *    *     *
** * ******   *
* *       **  *
*      *   *  *
***P     *** **
*     *     * *
*** **     *  *
*     *       *
** * * *      *
*   *  *K**   *
*  *      **  *
*  * ***   * **
**   *  **    *
**   *E * *   *
*       * * * *
***************