14 13
*************
*   **  *  **
* * *K***   *
*    *      *
*  * *** *  *
* E       ***
*      *    *
*       **  *
*  *  * *   *
**  *  *  * *
** P  *  ** *
** * * *    *
* *  *      *
*************