18 22
**********************
* * **   *  **       *
*K**     *    **  ****
** **     *          *
*   *   ** *  *** *  *
*  **  **    **      *
** * *   *     ** ** *
**        *   ***    *
* *        *   * *   *
*   **           *   *
*   *  *     **      *
**   *P*   *        E*
** * * **  *     **  *
** *      *        ***
*** * *     *  * * * *
**    * *  **  *     *
*   **  *    **   *  *
**********************