12 27
***************************
* *  * * * *    E  *  *** *
** *K     * ** *  ***     *
*  **  *  ** *    *       *
*     **    **     **   * *
**** *       * * *  *     *
*    * * * *    **  *     *
* *     * *  *    *       *
*  *   * * *P      * * * **
* * *    *           *  ***
*        *    **  * **    *
***************************