30 14
**************
*     *    * *
* ****   * ***
* *  * **    *
*    K * * ***
* **     *  **
*   **  *  ***
**      *    *
*    *   ** **
*        *  **
*    **  * * *
*  *      *  *
**    *     **
* *  *    *  *
*    *    ****
* *   * *** **
*      P     *
*   *E     * *
* *      *  **
*          ***
** *   * * * *
**      * *  *
*     *      *
****  **  * **
***          *
****    *    *
*  **   * *  *
**     ***   *
*  *        **
**************