20 13
*************
*   *** *   *
*     * *****
*  *        *
*  *   *  P *
* * *  K *  *
* ** *  *   *
***   *   * *
*   E  *    *
*** *  **   *
*        *  *
* **      * *
** **  **   *
*  * *   *  *
* *  *  *** *
*   *       *
*     **   **
* *    *    *
**  * *     *
*************