17 24
************************
* *       *  **  ** *  *
***  * *               *
**      * *     *      *
*  * **  **   P*   * * *
* *   *   *    *  ***  *
** *        ***   **K  *
* * *  **       * ***  *
** * E   *  * * *** *  *
****     *         *   *
*   *   *** *** * *    *
** *   * * * *  *      *
*            ***       *
*  *   **  *  **    *  *
*  *     **  *  **    **
* *  * *     ** *      *
************************