19 24
************************
** *  *   **     *  * **
**    *  *    *** * *  *
*   E *  ** ***  * *** *
*  *           *    *  *
* **  ***   *         **
**  * ** *      *      *
**                *    *
**  ** * *       *     *
** *  *       *       **
*  ***      * * *   * **
** ** *  *    **  * ** *
*   *   *   *    *    **
*  ***  * *           **
* * **  *P * *        **
**  **     *   *      **
***   **  K * *   * *  *
*  *                *  *
************************