12 12
************
* **  *    *
** * * P   *
*  *  * * **
* *  *   * *
* K ****   *
*  *   * ***
*          *
** E  *   **
*     **   *
*   **   * *
************