18 20
********************
* **  *            *
*  *      *      * *
*   *          *   *
*   *   *         **
* * ***   *   *    *
**  *        *  *  *
**  *** *  ** *  * *
*    * *      **   *
*    *  **         *
**  *  **       ** *
*E *  *          * *
* *    *      ** * *
*K* *  *     **    *
**  *   ****** *  **
*    **  **  *** * *
**  *  *  *   *P****
********************