28 14
**************
*  *         *
**** *  *    *
**    *  *K  *
*   *  **    *
**  *  **    *
**    * *   **
*** **     ***
* *    * **  *
**  *      * *
** *   *** ***
*  *      * **
* *      **  *
*        * * *
*       ***  *
*  P * *** * *
*   *   *    *
**      * * **
**  *  *     *
**   *    ** *
* *     * * **
*    *      **
* *  *  *   **
*   E* **    *
*      **   **
**     *     *
*  *  *   *  *
**************