26 17
*****************
*   ** **      **
**           *  *
* * * *         *
*    *          *
*   ** *  * *   *
*   *     *  *  *
*       *   * E *
* *    ****    **
* *  *  ** ***  *
*P* ***  **  *  *
*               *
****  *  *  *   *
*    *   *  *   *
*   **          *
**K*    * ***  **
* ***  *       **
**  ****       **
*           *   *
***     *      **
**              *
*  * *    *     *
**     **  * *  *
*  ** *** **    *
*       ***    **
*****************