18 22
**********************
*   * *  *       *   *
* *  P *   *   *  *  *
** * *   K * *       *
* *     *   * **     *
*   **   *       *  **
*  *   *    *   ** * *
***  *    *  * *** * *
*  ** *       ** *  **
*  *  **        *    *
* *  **   **** ***   *
*  *        * ** *   *
* *  **    * E       *
*   **    *  **    * *
*   *        **      *
* *          ** ***  *
*   *      * *     * *
**********************