12 31
*******************************
**  *  *      *  *****      * *
* *   *  *     *        *     *
*     * **      ** *     * *  *
*   ** * * *     *   *     P  *
*     *  *    *     *E   * *  *
***K  **      *     *** **   **
*   *    ***  *    *  **      *
***         **     ** **    * *
*  * *  ***     * *    *     **
*    **  * * *    * **   *    *
*******************************