19 12
************
*    *  *  *
*       *  *
** *   **  *
***        *
*    P  * **
*  *  ***  *
*  * **   **
*   *  *  **
*** *    K *
*       ** *
* *  *     *
**      ** *
*   **E   **
*    **  ***
*   *  *** *
*      * * *
**  *      *
************