19 18
******************
*     *    **    *
** P* *   * ** ***
**              **
* * **     **    *
**      *  * **  *
* *   * *     *  *
*  ** ***    **  *
*   **** *    *  *
*  ***  *        *
* * ****    * ** *
**   *  *        *
* * **    *      *
*E * *  * *   *  *
*  *     ** *    *
*  K  *  *   *   *
*   *** *   * ** *
*     *          *
******************