14 13
*************
**     *   **
*E      *  **
* * *   *   *
*   *   *   *
*   * *     *
*    ** *   *
* *   **    *
*   ***K * **
**    **    *
*   * *   * *
*      **   *
** * *   P  *
*************