13 23
***********************
***  *  *   * *** *   *
*  *              *   *
**  ****  *  E **** ***
***      *    *       *
*     ** *  *   *  *  *
* * *        * *** *  *
****      * * * *     *
*     *             ***
*  *          * **    *
*   *  ***  *** **    *
* KP       *   *   *  *
***********************