15 14
**************
*     *    ***
* *   * * *  *
* * * ***    *
** K  ***** **
* *   * **   *
*  *   *E*  **
***          *
*   *  * *   *
* *      *  **
* *    *P  ***
*     *  *   *
* *   *****  *
*         * **
**************