15 17
*****************
*   *  *P     * *
**        *  *  *
*   *   **    ***
**  *    *  *   *
*  *****     *  *
*  * *        * *
** *    ***  *  *
*   *K **       *
*  *   *   *    *
*    **     ***E*
*             ***
*  *         *  *
* **   * ***  * *
*****************