24 12
************
**         *
** * *     *
*    ** *  *
***   **   *
***  *  P **
*       *  *
**  ***   **
*       ****
**   *    E*
***    * ***
* **       *
** *  **  **
***     ****
**       * *
*   *      *
*   *  **  *
**  *  *   *
*    * *  **
*  *  *    *
*      **  *
* *        *
*   *K  ** *
************