17 22
**********************
*   **  *       ** ***
*  * *             * *
*  * * *             *
*** *    *    K  *   *
*  ** *  *   *      **
* *   *    * E ***   *
* *     *    ****    *
* **  *              *
*     *     * ** * * *
*   ***    *   **   **
*                    *
*    *   *  *    **  *
* *    *  * ***     **
*  P   ***  *  *  ****
* *  **      *   **  *
**********************