15 28
****************************
*      *  *  * *      *    *
* P  *    **   * ** * *  ***
*     **       ****     ** *
**      *       * *     ** *
****          *      E*  ***
*   *    *  **  *   *    * *
**     * **  *   *     * * *
*  **   *    ** ** * *   * *
****  **   *  ** *      *  *
***            *   **   *  *
*  *** ** *       *      * *
*  *       ** *     K  **  *
* **            *  *      **
****************************