14 25
*************************
*         *     *  K*  **
*     *   *  *  ****    *
*  *  *     * *   *     *
** *   **    *      * ***
*  * * *      **  ***** *
*            * *      * *
* **   **    * ***  *   *
***  E  *    * ***   *  *
**  *   *    *   *** ** *
*  *   *  *  * **   *   *
*   P   **        * ** **
*     *   ** *    ***   *
*************************