20 19
*******************
*     *  K *** ** *
**   *   * * * *  *
*   * *       P  **
* *  *   *** * *  *
**  **  *         *
* *    **    *    *
*        *    ** **
*   *       **  * *
** * * ****  *   **
*   *  *  *  * ****
*  * *    *    * **
*  * *       *    *
**E      *     * **
**  * **          *
*    *  * *       *
**   ** *   *    **
* ** *  *       * *
***  *  *    * ****
*******************