17 25
*************************
* *    *             * **
**   *   * ***  *      **
**   *   * ****       E *
* *  * *  **   *  **    *
*    *** **  *  **  *  **
* * *         *  ***    *
* *       *        **   *
**     *  *      * ***  *
*     **  **  *         *
*  * ***  * *  *   *    *
* *   *  ***   K *    ***
*   *      *      * * ***
*  *      *       *  *P *
*  * *     ****  * *    *
***  *     ***    **  * *
*************************