19 25
*************************
*   * *  ** *          **
* ***  **  *  *  *  *** *
*   *  ** *      *  *  K*
**            **  * *   *
* *     *  ***** *   ** *
**    P         **  * * *
**  *   *    * *  **  ***
*  *      * **   *      *
*   *   ** **  ***  **  *
*     * *       **      *
* **    *  * *     * *  *
*    **  ** ***  *      *
*  E  **      * *** *  **
* *                   * *
*       **  *      *    *
* *  *  **       ** *   *
*     **  *  **     * * *
*************************