21 13
*************
**       *  *
*  * *  *   *
*        *  *
**      * * *
*    K *    *
*   *** *   *
**    *     *
**      **  *
*    *   ****
*  *   **  **
* *  *  ** **
****    *   *
**   **     *
*    *   * P*
*           *
*  *      * *
* **     E  *
***   *  *  *
***     **  *
*************