14 21
*********************
*    E*    *       **
*  *               **
* **    *  **  *   **
*  * *    ***    * **
* **     *  *       *
*   * **       ***  *
* **   K      ** * **
*       **    *  ** *
* * **          *  **
* * **   **   *   * *
****P    * * **    **
*  ** *      **     *
*********************