12 21
*********************
*   *   *   *  *    *
*        *    * *  **
**    * **          *
* **           *    *
* * **  ******   *  *
**      K *E *      *
*  **  *   *    *   *
*    **  **         *
** ***   *** *  *  P*
* * *  **   * *  ****
*********************