27 12
************
*  *  **** *
*       *  *
*          *
*  P     * *
* * *      *
*  *  * *  *
*   *   ** *
***  ****  *
**  *  *  **
* *  *  ****
***      * *
*     *    *
** * *   * *
** * *     *
*          *
*   **  ****
* *     ** *
* **      K*
** *E  **  *
**   ** * **
* *     *  *
*  **   *  *
*      * * *
**    *  * *
*  *  *    *
************