17 12
************
**   K  E P*
*      * * *
*  *       *
*** *  *** *
*  *     * *
* * * *  ***
*       *  *
*   * * *  *
* ** ***   *
** * *  *  *
*  **      *
*         **
**      * **
*    ***  **
*       *  *
************