22 14
**************
**    *     **
* ** **   *  *
*            *
**  *     * **
*  *   **** **
*  *         *
*     *     **
*P *  *    * *
**           *
*  * *  ***  *
**  **** *** *
** * E *     *
*  * *       *
***   *    * *
*          * *
*      **  * *
*       K*  **
* * **   *   *
** *   *  *  *
**           *
**************