15 19
*******************
******   * *  * * *
* *   *  **  * ****
* **      * *     *
**        * ** ** *
*  *   ***       **
* *   *    * * *  *
*   * E *       * *
*       *         *
* K     **  *     *
*  *  *    * *  * *
*  *  *   * *     *
*  * *  *    **   *
*      **     P   *
*******************