21 15
***************
***  *      * *
**  *    *  * *
***    *  ** **
*        **   *
* * *      *P *
*    * * *    *
*  *  *      **
**      **  ***
***       * * *
*           ***
*   *     * * *
***E *    *K **
* * *  **   * *
*        ** * *
*  *    **    *
* **   *     **
* * *  *  *  **
* *  *  *     *
**      * *** *
***************