16 17
*****************
**             **
***  ** **   *  *
*     *  *    ***
*    **    *** **
*   *  E *      *
*  *  **      * *
**   * **  **  **
* *    *  *   * *
*       *  **  P*
*  *  *    **   *
*  ** ** *      *
* *   *  K      *
*  * *  *    * **
*   **   *  *  **
*****************