15 16
****************
*    *  ***  * *
*    *      *  *
*  **    *   * *
* * *        * *
*       * EK* **
*   * **    ** *
*  *     **    *
*   **   P* ****
* * *        * *
*  * *   *   * *
**       *   * *
*            * *
*   * *   * *  *
****************