14 12
************
*     *   **
*     * *  *
*    *     *
*  P** **  *
*    *    **
* * *      *
*  *  * *  *
*K  *  **  *
* *  *    **
** *  *   **
* *   *  * *
** *** *  E*
************