12 31
*******************************
* *    **          **         *
*     * ** * * *  *  *** **  **
*  *      *      *  *   *     *
** K   *     *  ** *     **   *
*     E    ** **   **   P  *  *
*         * ***  *  ***   *   *
* *            *** *          *
***   *      * * *  *    *    *
***  *     * * *   ****  *    *
*  **     *   *       * *  ****
*******************************