21 18
******************
*          **    *
* *  *    *  *** *
*              * *
* * ***  *** *  **
*        **P   ***
*     *  ****    *
* *   *** *  **  *
*     * * *      *
**  ** *  K    * *
*     *  *   * * *
* * **  *    *** *
**  **   ***   * *
**   *  E   *   **
*  **      * *   *
* * * *  * *   * *
*   **    * *  * *
* *   *   *      *
*     *     *  * *
*           **   *
******************