15 28
****************************
* *    * *      *K   * *   *
**      * *  * * P  * *    *
*         *   *    *  * * **
*  **  *      **     *  E  *
* *  *     * * *     *     *
*  **      *   *     **    *
*  *  * * *   *       *   **
*     ***   *    * * ***   *
*    *      *** * * *  **  *
*   *    *  **   *  ***  * *
*   ** **   * *  ** ** *  **
*  *          * *      *   *
**       ***        *   ** *
****************************