19 19
*******************
*    * * * ** * * *
* *       *     *P*
**     * *  *    **
*   * *  **   **  *
**    ** **       *
**      *       ***
*  *   **     *   *
*   **  * * * E  **
**     *  *       *
* *     *   *     *
*    * *      *   *
*   *   * *  * *  *
*        *   *  ***
* **  ** *   *    *
*    *   *  *     *
**  *   *      K* *
***       **      *
*******************