17 27
***************************
* *    *  *   **   **  * **
* *   *         *         *
**    *  ** * *           *
*     *    * * *    E * * *
*    * ** *   *         ***
**** * *    *  * **  *    *
**  * * P     **          *
*          **       ** *  *
* **   *  * *        * ** *
****  * * *   **    *   * *
****     *  *    *        *
*  * ****   *      *      *
* *K     *    **  ****    *
**   *** ** * *   *      **
* * **    *  *   *        *
***************************