14 22
**********************
*    **       *     **
*   *     *          *
*         **   *   * *
*  * *   **** *  *   *
**  *   *   *    *  **
***           *   ****
**E * *       * ** ***
* ** *    K *     * **
* *  **    *     *   *
*  *   *      * * *  *
***   ** *    P**    *
*     ** *   *   * * *
**********************