31 13
*************
*  *  *    **
*    **  *  *
* *  *   *  *
* *   *   * *
* * **     **
*    *    * *
*   * *    **
* *    *   **
*      **   *
* **    **  *
* *  * * ** *
* * KP *  * *
* *  **     *
** * **     *
* *      *  *
**      *   *
* ** *    ***
**    *   * *
*           *
*   * *   ***
*    *    * *
***  * *    *
**  *  *    *
*      *    *
*    ***    *
*** **  **  *
* *    *  * *
**   * E*   *
*  *  ** *  *
*************