28 17
*****************
** *      *  * **
**   **  * *    *
***       * * ***
*  **     **  ***
* * *    *      *
*           *****
*  ***  *      **
* * * * * *P  ***
**     * *   *  *
*   *     *   ***
*   *  **** *   *
*      *    *** *
*   **  *  ** * *
**  *        * **
*  *  *    **   *
*    * E    *  **
* *             *
*   **    *** * *
** ** *   *   * *
**      *       *
*     *   **** **
*     * *     ***
*       *      K*
*  *        *   *
*   *     ***  **
*   ** *    *   *
*****************