14 19
*******************
*    *   **  **  **
* *   *     K  * **
**   *   *    *  **
* *P  *        *  *
*     *     **    *
*  ** *  ** * *  **
**   ***     *    *
*  *** E         **
*      *     *    *
*     **          *
**   *          ***
**** * * ****  *  *
*******************