26 15
***************
*  *       *  *
* *    *      *
*** ** *      *
*     *    *  *
**            *
* *      * *  *
*  * *    *** *
**   *   * *  *
**** *   P    *
*  *     *    *
* *      *   **
*   *  *  **  *
*  *  *      **
** * *   *   **
**     * * ** *
*   *  **     *
*  *  **K**   *
****       * **
*  **    *    *
*     * * *   *
*     ** ** E**
* *  *  **  * *
**  ***  *   **
*      * *    *
***************