16 16
****************
*  **       ** *
*   * **   *  **
*P **   * E*   *
*        *   * *
*              *
* *  * ***     *
*  *      ** * *
* * K****  *  **
*     * * *  ***
*  ***        **
*       **     *
***    * *** ***
*              *
*   * * * *    *
****************