29 22
**********************
** ** *    *         *
* *   *   *  *    ** *
*    *    ** * *    **
*            *  *  * *
* *   *  **  **   *  *
**    *E    * * *** **
* *   * *   *   *    *
* *   *  * *** *     *
*      * *         ***
* *  *        *  *   *
*  *       *  *  *  **
*         **       ***
*           *  **  ***
*    ** **         ***
*   *    *      *  * *
* **  * *        * * *
* *    **  *  * ** ***
*   ** *            **
*       *   * * *    *
*        *   * *  * **
*  * *    * *  * *  **
** *  ** * * **    * *
*  *     **         **
* *   *K**  ** *  ****
* *        *  **  *  *
*     * *  *  **P * **
*      * * *    *    *
**********************