17 25
*************************
*    *  *    *       ** *
** *      **   * * *  * *
**       *      **  **  *
* **        *      **   *
*     * **   *  ****    *
*   *  ** * **  *   * ***
**        * *       *   *
*    *K*** *     * *    *
*         *   *   ** * **
** *      *     ** *    *
*    *     *  *       E**
*      * *    * *       *
* **** *      ** *  *  **
*   *   ***P      * * ***
*        * **  *    *   *
*************************