21 19
*******************
*         **      *
* *    * *      * *
****    * **   ** *
*    * *** ** * ***
*  ***P    *      *
*     *E     *   **
*  *  ** *  ** *  *
*  **  *  ***   ***
* ** * **     *** *
*  *   *  *     * *
**    *** *   *   *
**  *     **     **
*            **   *
**    * *  ***    *
*      *   K*    **
*    **    **   * *
**       *  * *  **
*         *   *   *
*  *     ***     **
*******************