13 18
******************
*   *       *   **
*   **     ***** *
*   * * *        *
*   *  *     *P  *
* *     **      **
*  *   *    *    *
* *     *  **   **
*  * * * ***  * **
* *K      *     **
***      *   *E* *
**  **   *  **  **
******************