16 21
*********************
* *      ** *  ** * *
*    *     **  *    *
*   *    * *       **
*            *  *  **
**  * *           E *
*   *  P****     *  *
**  *             ***
*** ***       **    *
*  *  * * *  K   *  *
*  **** **         **
*  **  * *     ******
*      *    * ** ** *
*         *****     *
*              *    *
*********************