16 25
*************************
*   *  *  K  **    **   *
*     * *    *  * *     *
*       *   *   *      **
* *  ***      *         *
*     *   *    *       **
*   *  *E*     *  ** * **
*  *    ** ****    **  **
**   *   * P      *     *
*    *  *   *    *      *
*  ***        **  **    *
* * *     ***     *    **
*** * * **      *** *   *
**   *  *   * **    **  *
*  ** **    ***  *      *
*************************