18 17
*****************
*  **    *     **
*         **    *
*     *   * **  *
*               *
**  *     *     *
*    *   *    * *
*  P      **  * *
*      ** *  *  *
*  * * * * *    *
*  *  *  ****   *
***  *    *    **
*  E    * ***** *
*      *  * *   *
*   * * * *  * **
*  ** * *    * **
** *  *K **  * **
*****************