24 17
*****************
* **    * *  ** *
* *    *    *   *
** *        **  *
***   P *   ** **
*      *    *  **
*               *
**  * K *  ***  *
*  ****  E* *   *
*      **       *
*  * *   * ** * *
*  * * *     *  *
* *  * *   * *  *
* ***  *   *   **
*  *   *** *    *
* *   * * ** ** *
*  *  **  *     *
*   *        *  *
*           **  *
***  **   * **  *
*               *
*  ** *   **    *
* ** *  *  *  * *
*****************