13 23
***********************
*       *       * *   *
*           *         *
* **    ***  ****    **
*    *      *K   *  * *
**    *      * **     *
*** * * * *    *      *
* *     **   * *  *E  *
*   ** *    *   **    *
*       ***   **     **
*    **   *****       *
* *    P*  *      * * *
***********************