23 12
************
** *  *    *
*   *  *  **
**    **   *
**  *     **
*        P *
*   **   * *
*** *  *  **
*      *****
* * *     **
*** *   *  *
* *       **
****  *    *
**        **
**      *  *
** *       *
**      K  *
*    *    **
**    *   **
*  E*  *   *
* * ** **  *
**  *      *
************