18 15
***************
*    **       *
* * P**    ** *
*    *        *
*  *   *     **
***   *  ***  *
*      *      *
*    * ** *   *
*    E* *  ****
* *  *     ** *
****  *       *
***     *    **
*    *K *   * *
*   *      *  *
*   * **  *   *
***  *  *    **
* **  *   *  **
***************