12 18
******************
*    ** *  * E* **
*    ***         *
*  ****  **    * *
*    * K * *  * **
*   * * *  *     *
*      *    *   **
*  *   *      P **
*      **     * **
* * *  * * *     *
**    * *   *   **
******************