23 12
************
*  *       *
**  * K    *
* *   P* * *
** *     E *
*    *    **
*     *    *
* *   * ****
***   ***  *
** *   **  *
*    *   ***
* ** *     *
*  **  **  *
**   **  ***
*****     **
*       *  *
*   * ** * *
***        *
**         *
* * *  *   *
*    *  *  *
*      * * *
************