27 12
************
*   P** * **
*       *  *
*     *    *
* * *     **
** *     * *
* *        *
****E**   **
*   *  *  **
*   **   * *
*   * *    *
* *      * *
**  * *    *
*  ** * * **
* *    K   *
*   *      *
*  *   **  *
* * ***    *
**         *
**** **   **
*  *    *  *
*  *  *    *
* *   ***  *
* * *  *   *
* **  *    *
*  *  **   *
************