19 18
******************
*  *      *    * *
**   *  *   * * **
***     *     *  *
*  *    *    *   *
*  *             *
**** * **  *  *  *
* E       * **  **
**      * *      *
* **  * *  * *   *
* *    ** ***    *
*      *K ** *  **
**   *    P*    **
** *     *   * ***
*  **  * * *  *  *
*  *        ***  *
* *    **  * *  **
***     * ** *   *
******************