19 22
**********************
*       * **   *  * **
*  *      *          *
*       *       ***  *
* P**  **  *  **     *
* *  *     *  **** ***
** *     *   *** * * *
*  *    *     * *   **
*  * *** * *     ** **
*  *   **   *      * *
* K  E   * **        *
**       * *         *
*   * *   *       * **
* * *    * *  **   * *
*  *   *      *      *
*  *   ***   *       *
*     *  *   * *     *
*   **  ** * **** * **
**********************