13 18
******************
*      ***       *
**  *  *  *    * *
***    **   *    *
*   *  ***     * *
**    * *     K* *
*    * **     *  *
**  *      * * ***
*     ***P   **E *
*   **        *  *
*       **   *   *
* *     *   *  * *
******************