23 16
****************
* *  *  *    ***
*    * *     * *
*         *  * *
*    ***       *
* *   *     ****
** * *       * *
*     *      ***
*          **  *
**          ****
* ** *    * *  *
*        ***  **
***** *** * *  *
* *     * ***  *
* * * * *      *
*   **         *
*  *           *
*  ****     *  *
*   *  E  * *  *
*    * *   * * *
* * *     *   P*
*K  * *  *  * **
****************