22 16
****************
*   *    *     *
*  P        *  *
** *    **    **
* * **     *   *
*** *  * **   **
* *     E *    *
*  *    ** *   *
*    *   *    **
* * * *  *  *  *
*   ** *    ****
*   **  *    * *
*  *       * ***
* **   * * **K *
*   **  *  *   *
*   *          *
**  *  * ***   *
*     * * ** * *
*      *       *
*              *
*  *      * *  *
****************