14 14
**************
*   *      * *
*          * *
*    * *     *
*        *   *
*    ***    K*
****  * *   **
* P      ** **
*  *  *   *  *
*  * *    ** *
* *     **  E*
**   **   * **
**      *** **
**************