17 23
***********************
* *   ** *          * *
*  *   *   *          *
* *    ** * *        **
*  E  *        *   *  *
* **K *     *     *   *
*      ***     ***    *
*  * * *  * *  *      *
* * *    *   ***   *  *
*    **     *  * *   **
**            *     * *
** **   **  * P * **  *
** *  **   **      ****
*    *  **   *   **   *
*      ** **        * *
*** *    **           *
***********************