18 25
*************************
**          *    *     **
***  *  *   **  **  **  *
*  *  * ***  **    *   **
*   **    *   **    *   *
* **            *    *  *
**  ***  *  * **   *  * *
**      *   *  *  *     *
**  *K  ** *     ** *   *
*  * * * *    *  *      *
*    ***        **      *
*  *  *      **   **E * *
** **  *   *   *  **    *
*  **  * *     ***  *   *
*     *      **      *  *
*    ***      * *  **   *
* P   *   **  *   * * ***
*************************