17 16
****************
*   * *     ** *
*  *EK    **   *
*     ** ** *  *
*      *   *   *
* *  * * *  *  *
*         * *  *
*   *   *     **
*     * *     **
* * *  *   * * *
**   **  **    *
***   **   *  **
*P  **   * *   *
**   *** ** *  *
*     *   * *  *
*      * *   ***
****************