19 17
*****************
**    * K  * ** *
*          *    *
**         *    *
*       *   ** **
* *  ***       **
*****  ***    ***
* *    ** *    **
*    **** ***P* *
* *   *         *
*  *     **   * *
*  *   *  *   E *
***   *     *   *
*   **     * ** *
**  * ** * **   *
***         *   *
**     **    *  *
*   *           *
*****************