23 13
*************
* *P E**  * *
*   *       *
*  *        *
*   ***     *
*         ***
* *  **    **
*  *  *     *
*       *   *
***      *  *
***  *    ***
*  *   * *  *
*      *   **
*          **
* *****    **
*  ***  * * *
*       *K  *
*   *      **
* * ***     *
* * * ** *  *
***      *  *
**     *    *
*************