25 14
**************
*    *  *    *
*     **  *K**
* *    ***   *
**     *  ** *
*     **     *
*      ***  **
**    *    * *
*****    * * *
*  *  *   *  *
* **  *  *   *
*        *  **
*    *    * **
*       * ** *
**          **
*  **      ***
* * *      P**
*  *   *  *  *
*   **     E *
***        * *
* ***  *  *  *
* *  * **    *
**    *      *
** *   *   ***
**************