23 18
******************
* *           E  *
***  *   ** **   *
*    K   *  *  * *
*     * * **  *  *
*  *    *P       *
*         **   * *
** *  * *  *     *
* **     *  *    *
**  * **    *    *
*  * * * *  ******
*     **       * *
*   * *   ** **  *
*    * *  *  *   *
*       *   * *  *
** * *  **   *  **
*   *    *       *
**  ** *     * * *
***  * *  ** *   *
* * *   *       **
* *   * *        *
* *     *   ** * *
******************