18 17
*****************
*  *   ** *  ** *
* **    *       *
***      * *    *
*   ** ***  * K**
***  *          *
*  *   **  *   **
*   *     *     *
* **      **  * *
*    ** P*  E   *
*  *            *
*    *** *    * *
***   *      * **
**   *  * *   * *
****    * * *   *
* *  * *      * *
* *   * ***  ** *
*****************