12 12
************
*     *    *
* *        *
*E*** K* * *
* *     ** *
*          *
*    *     *
**     ** P*
* *  ** * **
*        * *
*  *** *  **
************