26 13
*************
* **    * * *
* *      ** *
**    **   **
*  *   * *  *
** *        *
**K   **  ***
*          P*
* *         *
**  * *    **
*    **** * *
*    * *  * *
*   *       *
*     * ** **
* **  ***   *
*      **** *
**   *  *** *
*   E     * *
*  *  * ** **
* ** *      *
*   *   **  *
***       * *
*     *   * *
*     *   * *
*   * *  *  *
*************