19 20
********************
*  * *  ** *       *
*    **  *        **
* ***      *   ** **
** *   * ** *    * *
**  *       *    * *
*   **     *   *  **
*     *  *   *  ** *
*     *  **  * *  **
**  ** *  **  *    *
*  **  * *     *** *
*     *  * *       *
*  **   *          *
* *P    * * *   *  *
*     * *  *   *  **
*  * *   * * *    **
***  **   *    **  *
*   *E   K * *     *
********************