17 27
***************************
* * *  *              ** **
*   * * * * *  *     ** * *
***  *    ***  K **    ****
* **  *  *  * * **        *
* *  * E  ***    **P *   **
**   *   ***   *         **
* * *  *  *  *     *      *
**   *   *      *         *
*        *    **          *
**       * *   *    ** * **
**** *  *     *** *    ** *
*     **  *  * *   * *    *
**        *  * * *     *  *
*           *           * *
*  ** ***   *    *    *   *
***************************