13 22
**********************
*    *        *   *  *
*  *   E  *K *    *  *
**    **   *  * *   **
*  *   ** *    *  *  *
*  *  P     *  **   **
*     *    * **    ***
* *    *   **** **  **
*  ***        *  *   *
*  * *     *  * *    *
** *   **   **       *
*    ***  *   *   ** *
**********************