15 16
****************
*E * * *    ** *
*  *  *  *     *
*         * *  *
*   * *  **  * *
*  * *    *    *
*   **     *  P*
*     *        *
**      *  * * *
*  *    * * ** *
* * *    *** ***
*  *  *   * * **
**   K   **  ***
* *  *    *    *
****************