20 12
************
*  E  **   *
*  *  *  ***
*        * *
*     ** * *
*** * **** *
* *   ** ***
*      **  *
**     **  *
* ***   *  *
*  P* *    *
*          *
*        ***
*    **   **
* * * *   **
*   *  *  **
*  *   *   *
*    *   ***
**   ** K* *
************