15 14
**************
* *P*       **
* * * E **   *
* *    *   * *
* *  **  *   *
*  **  * **  *
*K *      ** *
*  *  *   *  *
**  *        *
*        *  **
* *   *  *   *
* **    *   **
* ***       **
* **      *  *
**************