24 17
*****************
*  *  *         *
*  *     * *P   *
*   *          **
*    **     *** *
****  *  *** *  *
**    ***    * **
*     *  ** *   *
*  *  *  * **   *
** *  ** ** * * *
*E *         *  *
**        * *   *
**    **   *    *
* ** *    *     *
*     *  **     *
*   *    **   * *
** * *  *       *
*****    *     **
*** **  *   ** **
*               *
** *  * * *   * *
*  *** **  K  ***
**  **        * *
*****************