14 15
***************
* **         E*
**  P     * * *
*       *     *
*          *  *
***     *   * *
* **      *   *
*     * ** *  *
**  * *       *
** * *  ****  *
**  *  ** * * *
*    K*   *   *
* * *    **   *
***************