24 14
**************
*****     *  *
*** *  *  *  *
*    *  *    *
***   **   ***
*  * *   *** *
*            *
*            *
**   *   *   *
**  ** *    **
*  **   *** **
* K          *
*  * **   *  *
*  * * *  *  *
****    * ****
*    ***  *  *
**       *  **
*    *   *  **
*    ***    **
*P    *    * *
*   *     *  *
*   *E*      *
*     *  *   *
**************