14 31
*******************************
*    * * * **    *      ** *  *
*        ** **  *** *  ** **  *
*  *  *  ** *     * ***** **  *
*  K      *      *    *   * ***
* *    * * *    ***   *       *
*****   * *     *    *  **    *
*    *  *  ** *  * *    * *   *
**   *    **    *** *    ** * *
* ***       E  * *      *     *
*   *  **  *  *  *          * *
*              *** *  *      P*
*   *     * *       *    * ** *
*******************************