15 18
******************
*    E  * *     **
* *       * * *  *
* *      *  *  ***
**     * **  * * *
*****     *  * * *
***  *      *  * *
* **    * *   *  *
*  * ** *K   * ***
*          *     *
*          ** ** *
* *  *P  *  **   *
* *     **       *
*   * **   *     *
******************