13 27
***************************
*** *      * ***  *   **  *
* *   *  *       *   *   **
** P         **  **  *   **
**    **  *     *    ** * *
**    *   *     *   *** * *
*       ** *     *     ** *
*       * ** *   *       **
* * *       **       *K ***
*             **   ** *** *
***           *     *   ***
*   *  ** * *E    **   * **
***************************