21 21
*********************
* * **   ***  *  ** *
**  *    * *K ** *  *
*   *    * ***    ***
*   **    * *  **** *
*  *          E     *
*  **      **    *  *
* *   P**  * **  *  *
**    *  *     **  **
* *    *   *     ** *
***   *   * * *     *
**    *         **  *
*        *   *      *
* *    *    * * *   *
***   * **    *  ****
* *     * * *   *   *
* *        * *      *
* *     *  *     *  *
*    *  *           *
*** ***   **      * *
*********************