18 29
*****************************
*      *   * **    * ** * * *
* *    ** *    *      **   **
*   *        *    *  *      *
*    *   **    **     *   * *
**    **   *  *** *  **  *  *
*   *  *      *           * *
*E*        *  ** * *** **   *
*      *     * *   *   *  ***
*  *   **  *         * *  ***
*     * *    *  *    *    ***
*        ** P*     **   * * *
*  **    ***   *          * *
*              * *    **** **
*        * **K*    ** **   **
* * *  *    *     *** * *   *
*    **           **    *  **
*****************************