17 18
******************
*  *   *       ***
*            *   *
* *      * ***  **
** *  **  * *  * *
*        ** *  ***
* *  * *         *
*   K E ****     *
*  **  *       * *
* * **      * *  *
* P  *        *  *
** *       ** ** *
***          *   *
* **            **
*** *         ****
*   **     *     *
******************