15 18
******************
*     *  K    *  *
*  *    P        *
**         *  E***
***** *  ******* *
*  *  ** * *  ** *
***   **         *
*   *  *  **     *
*  * *     **    *
*    **   * *   **
*   * *     **   *
*      *   * **  *
*    *          **
* * *  * * *    **
******************