22 19
*******************
* **          **  *
* ***  * *        *
*        P *  *** *
*    *  *  **  *  *
*     * ** *    * *
* * K   *   **  * *
*      *  **      *
*** *  *       ****
* *           *  **
*  * **  * *   * **
*   *  **   *  *  *
*   *   *  * * ** *
** *   *   *      *
*      *  *  *    *
**  *   *     *   *
**  **     *   *  *
*    *  *   **  ***
***  *   *   **  **
* ** ** *     **  *
**   E   *  **    *
*******************