13 31
*******************************
** ** **       *   *          *
*  * *  E  * *   *  *       * *
* *     *  *      *   *  *  * *
*  * * **  *        ****      *
*    * *P*   *   **  *    **  *
*** * *   **   * *         *  *
*  *   *** **   * *  *        *
*        *     * *  *    *** **
*   * * *  **  * ***       ** *
* *  *   K ****        *     **
**   *      *  **          * **
*******************************