14 21
*********************
*  ***  *  *      ***
* * P  * * *   * ** *
**       ***   *  * *
*    * **  ****   ***
* * *         *    **
**   *  *     *  * **
*  *   *    * *    **
*     **  *  *  ** **
***      E *  *  ** *
* *   * * *         *
* K*               **
*         **    **  *
*********************