31 12
************
*    *     *
* *    *E* *
*   *   * **
*       *  *
*    * *   *
**     *   *
** * **    *
*       ****
**    *K** *
*  * ** *  *
*  **    * *
***  * *  **
**    * *  *
* * *    * *
* *      * *
*  P**  ****
*     *  * *
*          *
* *      * *
* *       **
* **     * *
*   * **   *
*   **    **
* * *      *
* *   **** *
* *     *  *
*       ** *
*  *   *   *
* **  *    *
************