17 13
*************
*   *    *  *
*          **
**  *       *
*      *   **
***   * ** **
**K         *
*   * P   ***
**    E    **
* *     *  **
**      **  *
* * *     * *
* ** ***  * *
* *  **   ***
*      **   *
*     * *   *
*************