14 29
*****************************
*  * *           *    K*  * *
*  *   * *     *  *     *   *
**   **         **   *  ** **
*       *    *  *  **  *    *
*    *      *       *  P    *
*   *       *    **   **  * *
*****  * *  **  *   ***   * *
*   ** * * *    **   * * *  *
***   *   *      * *        *
*      **E*    *    * *  *  *
*** *   ****   *   *    *  **
*        * *  *  * ** **  * *
*****************************