16 23
***********************
*   *   *         * ***
**    *  *       *  * *
****     **     *     *
*    *  *           * *
* ** **  *    ***   * *
*  * * *  *  *   * *  *
*      *  **      * P**
***   *  *   **   *   *
** *   K** * ******   *
*       **   * * **   *
*  *     *  *** * *   *
* * * ** * * * *  *  **
**  * E               *
*        *       **   *
***********************