26 13
*************
*    *   ** *
* *   *     *
*  **  *   **
**     **  **
**      *  **
* ** ***    *
***    *    *
**E* * * ****
** *       **
*      *    *
*  * *  * ***
*  *    *   *
**   *  *  **
*       P   *
*    *      *
* ****      *
**K * *     *
*    ** *   *
*     *   * *
** *        *
*  * *     **
**  * * *** *
*   **  *   *
**    *   ***
*************