27 13
*************
*       *   *
*  *     *  *
*   ***   K *
*         * *
*  * **  *  *
*  *       **
*        ****
*      *    *
*  *   **   *
*       *   *
**   *      *
**   *   *  *
* * *** * * *
** *  * *   *
*  **  **   *
* *   * *** *
*  *  * *  **
*           *
*   *  * **E*
** ***      *
*     *    **
* * * *  ****
* **       **
** ** *   P *
* * **    ***
*************