26 16
****************
*   * * *  *   *
* *            *
*   * **  *  ***
**     * * *  **
*** *         **
*  * *        **
*    *     * * *
**   K    * *  *
*    *     ** **
** *      *    *
*  *      **   *
*** **   * *   *
*  ** *        *
**  **       * *
**           * *
* ****  **    **
*         *  ***
* ** * **  *   *
*  * **    *   *
* *  ** *  **  *
*  **  *     ***
** ** *  *   * *
* E   *    * * *
*  * P*      * *
****************