20 22
**********************
*   ** * *      **** *
*      *  **  * *  * *
*  **    *  *  *  * **
*    **    *      * **
*       * *  *    P  *
**   * *          *  *
** *  *  **      * * *
** *   **   ** * *  **
*   *          ** ** *
*  * **    **  ***   *
*  *E * * *  *** *   *
*    *    *       ** *
*  *     *  * * * *  *
* *    *    * *  * * *
*          *    * ** *
* *      **       *  *
*K * *    ****      **
*    *    **      *  *
**********************