26 32
********************************
*   **     * ** *     *    *   *
*    *      **      * ****** * *
**   **      * *  **     *   * *
*    *    *  * * *   *     * * *
*    ** *  * *    *        *   *
** *   *  * *   *   *  ** *   **
*          *     *  * *     * **
** *  **     * *        *   *  *
*      * *  *   *** *   * **   *
**         * *    *   *        *
**     *** *   *  * *  *     * *
**  **    *    *        *    * *
*   *  **           *     *    *
* *   *** *        * ***   *   *
* *  *   **  *   *      *** *  *
* *   **   *    *    **     ****
*    * *  *P**  *  **        * *
**    * **    **    *    ** ** *
*  *    *  ***  *         *    *
* **   * * **     **     * *  **
* E *  ***      * *         * **
*     K   *     *** ** * * *   *
* *   *       * *      **  *** *
* *      * * * * *      *   * **
********************************