13 13
*************
*  K* * *  **
*  ** *    **
* * *       *
**  * **** **
*  *       **
***   *    **
*  *   E*   *
* *    *    *
*  **     * *
*    *   *  *
*   * *   P**
*************