22 13
*************
*     *  *  *
**    * **  *
*   *   *   *
* **   *    *
*      *  * *
** *   *    *
* E  *   *  *
* *  *      *
*****   *  K*
*** *    *  *
***  *  *   *
**       *  *
* P   * *  **
*    * *    *
**    *    **
*  **** **  *
*  * *      *
* *   ***   *
**   * *    *
****   * *  *
*************