25 24
************************
*            *         *
* * *       *        * *
*   * *   *   *  *     *
*     *   *   *    *  **
*   * *  *   *  *   ****
* *  *  **   * *****   *
*      *            *  *
*   * *  * *   *      **
**    *   K** **** *** *
* *    *E* * ** **  *  *
*          *  *   *** **
* **       *    **  ** *
*  *   *    ** **      *
*** ** *          *  * *
*     **     *   *     *
**    *  **     *      *
**  * **   **  **  *   *
* *  * **      **    ***
***  * *         *   * *
*      **    * *       *
***             ***  * *
*  *        * **  **   *
*          *   P   *** *
************************