16 12
************
*    *   ***
**  *      *
*  ** **   *
*  *P   *  *
*     * *  *
*  *       *
**     **  *
*  *  * E **
*    * *K  *
**  ** *   *
*    * *   *
**    * ** *
*  **     **
* ** * *   *
************