26 12
************
**     *   *
*     *    *
**     E ***
*  * *  *  *
*  * ** P***
***    *   *
**   *     *
* * *     **
* * **     *
**   *     *
*   *      *
*      * ***
*  *       *
*    *    **
*       ****
**  ** * K *
**       * *
*  ***  *  *
* *      ***
* **      **
*  ** *    *
*   *  *** *
* *        *
***   *  * *
************