16 18
******************
*    *   **    * *
*  ** *   * E    *
* *       ***  ***
***     * *   *  *
*    *      ** * *
* * *** *      * *
* *       P* *  **
*    *       **  *
*    *  * *      *
*       *       **
**  ***  *  *  ***
*     *** ***    *
* **             *
*     K *        *
******************