14 20
********************
*    *  ** P       *
*     ** *       ***
*      *     *  *  *
*       *** * *   **
**  *  *      **   *
*  *   *  **  *    *
*  *    ** *   *   *
* ****  *  ****  * *
*   *  *        ** *
*  **  **  * ** K  *
**      *       *  *
*   E  *   * **    *
********************