12 29
*****************************
*  ***** *        *     *   *
* * *    ** **    *     *   *
*     *        * * *   * ** *
*  K*  *   *        **      *
*** **E**    **   *    **   *
** *   * ** *       ******* *
*   *       *  *       *  * *
* **  *   *  *    *         *
***        ***      * ***   *
*            ***         P  *
*****************************