18 12
************
**    * ** *
**   * P* **
*   **  *  *
*   *     **
***        *
* E *      *
* *  ***   *
*    *  *  *
** *  *** **
* *       **
**   *  *  *
** K  *    *
**    *    *
* *        *
***     *  *
*   * *   **
************