21 19
*******************
*     *    * * *  *
**  *  *       *  *
* *   **  *     * *
*** *   *  * **   *
*       *    **  **
* **       *    ***
*   *       **  K *
*    *  **     ** *
*      * **** *   *
*         *  *  * *
** ** **         **
**       *  **    *
*     *  *   *    *
*    *  *  * * *  *
*  * ***  P* *  * *
**      * ** **   *
*   *   **        *
*  * E        *   *
******    *   **  *
*******************