20 17
*****************
*          *    *
*  * *    ***   *
* * *    K      *
*   *  * * *   **
*** ** *   P * **
**  *     *** ***
* *            **
***  **   **    *
**  *   *    *  *
* * * **     ** *
*  * *    ** ****
**   * *   *    *
*    **      * **
*      E      * *
*     * * ***   *
*    *   *    * *
*     **     *  *
*   **   *      *
*****************