12 21
*********************
*       **     *  ***
**   *     * *      *
*  *     *      *   *
*     * * **       **
**   *     ****  *  *
*   ***  *    ****  *
** **   * *      * **
*  K**    P   *     *
*   *E   *      *   *
* *   *   * * *  ****
*********************