15 12
************
*       ****
**      *  *
*      ** **
* *      ***
* P        *
*   *  **  *
* *  **    *
*  * *** K *
** *  ***  *
*    * *   *
*         E*
* * *  * * *
*  * * *   *
************