14 25
*************************
*   E     *  *   *   ****
*  ****       *         *
*  *  *        * *  **  *
* * * *        *   P *  *
* * * ** *  *           *
*   *  ** * * *    *    *
***   *       *  **   * *
*   ****    *K  ** ***  *
*  *     *    *      *  *
*      **     * **      *
**    * ** ***    * *   *
*    **  * * * **     * *
*************************