13 18
******************
** *P  *     **  *
*    *   *** **  *
* *         *    *
*    ** *     * E*
*       *     * **
*   *  *      *  *
**    * **  *K** *
*       **   ** **
***            * *
*   **  **   **  *
***  * ***   *   *
******************