18 18
******************
**   ** ***      *
* ** *   **     **
* *     * * * *  *
** *   ***   *  **
*    *     * *** *
*     K *  **   **
**        * E ** *
*       *     *  *
*    *     *  *  *
*      *       * *
*  * *   *    ****
**  *    *   **  *
****     *   *   *
* *   *    ***  **
*   *      * P*  *
*           * * **
******************