26 19
*******************
*       **      *K*
*    * * *    * ***
* *    *   * * ** *
* *     *       E**
***   *   *  *   **
**  **         *  *
**      ** **     *
*  **  * * *      *
*      *   *     **
**   * **  *  *** *
* *  *  *    *  * *
* **  * *    *    *
*  *    *  ***   **
*    ** * * ** ** *
**    * *    P*** *
**   **      *    *
* * *    *  ** *  *
*        *        *
**  **   ***  * * *
*       *         *
*     *  * *      *
*       **  ** * **
*                **
** *  * *    *  * *
*******************