23 15
***************
**      *     *
*      *  **  *
** **      P* *
* *** *     * *
* ****    *  **
* *         * *
*      * * *  *
*       ****  *
*     *     * *
** *   *****  *
*           * *
** **  *     **
**          ***
* *    * *    *
*   *  *  ** **
* **  **      *
*  *  *   K * *
*   * *  E *  *
*     *  * *  *
*     *  *    *
* *  **  *    *
***************