27 12
************
*  *  *  * *
**     *   *
*       *  *
*      K*  *
**  * *  * *
**  *    ***
****    *  *
** *  **   *
*    *    **
**   *   * *
*  P   *   *
*   *   * **
*    **    *
**         *
* *  * ** **
** ** *    *
*  *      **
*     *   **
*    E *   *
*   *      *
*   *      *
**  ****   *
**   **    *
****       *
* *   *   **
************