16 18
******************
*  *      *   *  *
*    **     **** *
*      *         *
*     * * *   *  *
*P     *       ***
***    *      E **
**  **   *  *    *
*   *       **   *
*    **   *** ** *
***       ** *   *
*  ***    *K     *
* ** ** *   ** * *
* *   *  * **  * *
*            *   *
******************