17 19
*******************
*    ****   * *****
*     *    *      *
*   *      *     **
*  **   *      *  *
*   *  * *      ***
**  *        *    *
*   *   * ***  *  *
****  * **      ***
* **     * *   *  *
* **  *         *P*
*   *  *      *   *
* *  *E           *
**          *  ****
***    * **      **
*    K***  *  ** **
*******************