20 21
*********************
*    * *     ***   **
**         *        *
* *       *  *** * **
*  ** **     *    * *
*   *   ** * *    ***
* *  *      ***     *
**          ***     *
*  ***  *      *    *
*  **      * *  **  *
** ** *  *      K* **
** ***        *     *
* *    ** *    **** *
*       *     *    **
*  ***P *      *   **
*     *       ** * **
*             *    **
*   *    **    * *  *
* E    ***  *    *  *
*********************