24 23
***********************
*     *   * *    **  **
* * *  *         *    *
*   *    *            *
*    *    * ** ** **  *
** *        *         *
*  *     *   *  * *   *
*            *   *   **
** *   *    * *     * *
* *** *  *** *     *  *
*  *      *    **  ****
*  * ***     * **    **
* ***  **  * * *    * *
*   * *       **      *
**      **    **  **  *
* **     *    * *  * **
*  *    * *  *    * ***
*         * *   * * ***
*  *  *K          * * *
*     * E   ** *   ** *
*       *  *  *     ***
*  *    * *   *     * *
*   * *             P *
***********************