14 22
**********************
*  *   *    E **  *  *
*  *     * * * **    *
**     ** **  *  * * *
** * **         *    *
*      *             *
*      ****          *
*  *   ****  *   *   *
*     *** *    *    **
*   * ** *  *   P    *
**  * * *   K       **
* * *  ** **  *      *
*   ** * * * **     **
**********************