19 14
**************
*     * **  **
* ** *  *    *
***    *     *
****  *    * *
* **       * *
*           **
**  E        *
*    *   * * *
*     *  **  *
*          * *
* * * **     *
** *  **   ***
*   P* *     *
**       * * *
*        *****
* K **      **
* * *  *     *
**************