25 12
************
* **   **  *
*   *  * ***
* * **  *  *
** * *  *  *
**    *    *
*  E  *    *
* **     * *
* *     * P*
*       K  *
*  *       *
*   *   *  *
*    * *   *
*   *   *  *
*  *   *   *
***   * *  *
**  * *   **
*  *   *   *
**  **   * *
** **    * *
**  * * *  *
**   ***  **
***    *  **
*   *   *  *
************