27 19
*******************
*  *    *     *   *
*  *            P**
**   * *  **    * *
*    *      *  *  *
*   *** E * *    **
* K  *  *      ** *
*   *   * ***     *
*       **    *   *
** ***  **  * **  *
*  *   * ***  *   *
*****  **  * *    *
*  *         * *  *
**  *     *   *  **
* *** * *  *   *  *
*  *     * **     *
****           ** *
*      *   *   *  *
** **   * *** *   *
*    *   * *      *
* *   ** *   *  * *
*  **    **  * ** *
*  ***       *    *
*        *   *    *
**   **    * ** * *
** *          *   *
*******************