20 12
************
*   *      *
*   * *  ***
* K*   **  *
*     **E  *
* *   P    *
**   * *   *
* **  *  * *
**   *   ***
*  *  **   *
* ** *     *
*   *      *
**    **   *
*  * *     *
**  **   * *
****   **  *
***        *
**       * *
*  ***     *
************