18 16
****************
* **  **    *  *
*   **      * **
*       ** * * *
**         **  *
*  **** * * *  *
*  **       *  *
*       *  ** **
*    *      *  *
*    ***      **
** *    * *  * *
*   P          *
*  *   * *     *
**   K *  *  * *
*  *    *     **
* *  * *    *  *
* * *** E      *
****************