16 19
*******************
**         *  *   *
*  K *            *
**   ***    * * ***
* *  E *     ***  *
****        *P    *
*       * * **  * *
*     *     *     *
* **    * * * *  **
***   *    ***  * *
**        *    *  *
*   * **  *       *
**** *  **  **** **
** ***         ****
* *           *   *
*******************