14 20
********************
*    *   * *      **
** **   *  *      **
*  *    *      ** **
** *   **  * *   ***
*           ** K   *
*   *    *         *
**    *P***     ** *
**     * *    ******
* * **  *  * *    **
**  **          *  *
* *  *   *  *  **  *
* *    *    *  E*  *
********************