14 26
**************************
**          *       *    *
**   **       * *     *  *
**  **    *   * P   *   **
** **  *  *E*  * ** *  ***
*           ** *       * *
*      *          *  *   *
*  *          * *  K   ***
***      ***** ***      **
** **    * **  ** * *   **
****  **  **  * *        *
*     ******     * *  ** *
* ***     *        *  ** *
**************************