15 26
**************************
* *  * * ***            **
*       *       ***    * *
*    *  **  **           *
*  **  **    **  **      *
*     *      * ***      **
*  ***    *      ***     *
*  ****       *     *   **
* *      **             **
* * *   *  ** *** * *    *
* *   *  **  **    *  ** *
***   **          * *  * *
*   E*     * P * *  *  * *
*        ** *   *K       *
**************************