16 21
*********************
* *** *   *   *     *
* *   *    *** **   *
* *    ** **  ***   *
** *     *          *
***     *           *
* *  *E   *     * ***
* *    * * *  *     *
*   * * * *  **  *  *
* *              ** *
* *  K*          ** *
*    * *      **  ***
**   *    *  *   *  *
**  *     *      ** *
*    * ****P    * ***
*********************