18 19
*******************
*  *  *  *   **   *
**   * ** * * **P *
*   *   **     ** *
*  * *            *
*   ** *  *****   *
*  *     *        *
* **  *       *** *
*    **  ***    ***
*   *     *   E * *
* * *  *      *   *
**   *       *   **
*    *    *    K  *
*     *       * * *
*       *  * *   **
*  *   * * *   * **
*       ***  *    *
*******************