24 13
*************
*  **  * ** *
*  **  * ** *
*  *        *
*        *  *
*     *  *  *
* *** * *   *
*  *   ***  *
*    ** *  P*
* *         *
*  ***  *  **
*  *        *
*    * *   **
*  E  ** * **
* * *       *
*        * **
*  * *  **  *
**  *    ** *
*           *
*   K**  ** *
*     ** * **
*    *     **
* * **  *   *
*************