13 17
*****************
*   *      * * **
*   * *     *   *
*     *  **     *
**  *      **   *
* *   * P * *   *
* * E** *       *
*  ** *     *  **
*** *   *    *  *
** *K **     * **
***        *  ***
* **    **   * **
*****************