12 20
********************
***   K* *   *     *
* *    *  *      * *
* ** *      *      *
*     *      **  * *
** * *       **** **
*** ****  *  **    *
**       *    *  * *
*  * *   ** E     **
* *   ** *  P  *   *
**      *  * *   * *
********************