14 25
*************************
** ***  ***  **   *    **
*         ***           *
*    *      **  *  *    *
***   *    * *  **      *
*   **      *   **      *
*     * *  P    * E   * *
*****  * * **       * * *
*   * *   *  * * *  **  *
**         **      * ** *
*   * *    *   *     K **
*** **    * *    *      *
*    **  * * ***    * * *
*************************