12 14
**************
***  *     * *
*    *    * **
*    *  ***  *
*   * * *E*  *
*  K *   *  **
**     *   ***
* **   *   * *
*      *  *  *
*     *   *  *
* * P*     * *
**************