21 15
***************
* *         * *
*  **  *  ** **
*    *   *    *
** * *        *
*    K *  ** **
*   **      ***
*E           **
* * **     ** *
**  **    *   *
*     P   *   *
** * * * * ** *
*** *  *  *   *
**           **
* ***  **  *  *
*     * *  *  *
**   *   *    *
*  *        * *
**        ** **
** *     * *  *
***************