16 16
****************
*  *  *  *    **
**  ** * *  *  *
*        *     *
*       *      *
*       * * ** *
* *  *** *     *
**   ** **   * *
*K  **    **   *
*      *  ***  *
*      ** *  * *
*        **   **
*         *** **
*    * * * PE* *
* * ***      * *
****************