13 25
*************************
*      *      **    P   *
* *   * *  *  *  K*     *
**    **   * *          *
****    *     * ****  * *
*       **  *** *     * *
* *    ***  * E  *  *** *
**** ** *        *  *   *
* * **             *** **
* *            *  *  *  *
*   *            *     **
* *****      *       *  *
*************************