14 32
********************************
*        * * * *   *        *  *
**  **  *   **   ***  * *   *  *
*      **      *         **   **
*    *   *   ** ****      *    *
* **   K  E* *      *  *       *
* *  **  *           *      *  *
*     *    * *** *   *  ** **  *
** ****    *    *      * *   * *
*  ***  *  *  *    *   *   P** *
*         *    *    *  * **    *
* *   * *  * *      *      * ***
**   ** *  *   *     ***   *  **
********************************