18 18
******************
*    **    **    *
*     * *   * * **
****   *         *
*  **   *        *
* * *   *  **    *
**** * *****  *  *
*         ***    *
*  E*           **
* *  *P*  * *  * *
* * **K    **    *
*        *   *  **
* * *  *  **     *
***              *
*       *    **  *
*  ***    **     *
* **   * *      **
******************