12 15
***************
*   * P    ** *
**      ** *  *
* **      * ***
* *   *  * *  *
*           * *
**   K  **    *
* * *  * * *  *
*  *  *    * **
*    **     E *
*   *     *   *
***************