21 16
****************
* *   E ** *   *
**   * **    ***
*     ***  * * *
*  **    *  *  *
*              *
* K* *    *  * *
*  *  **      **
*  *       *** *
* * *   *    ***
* *        *  P*
* **     *    **
*      *     * *
* ** ** *  *** *
* *  * *  *** **
** *    *    * *
**             *
*  *  *        *
***      **   **
**      **  *  *
****************