20 17
*****************
*     *     * * *
*   *         * *
** *      **   **
*        **  *  *
*   * **      ***
**  *   * *     *
* * * *  E  *****
*      *  **** **
*            *  *
*   **         **
*  *  * * **   **
**   * **    *  *
*   * **   *    *
*     *      ** *
*     ** **     *
* *           ***
* *      *P   * *
*   *   K *  ****
*****************