19 16
****************
*      K*   * **
*   *  * *   * *
** *       *   *
*   *** *     **
*  *      *    *
*    *    **   *
*  *   *  *    *
*     *  *     *
** *     E   * *
**       *     *
*    * *    * **
*   P     **   *
*  * *    * *  *
**       * **  *
*  * ** * *    *
*  * * *   *  **
*******     * **
****************