32 13
*************
* * * * ** **
* * **  * * *
*           *
*  *   * ** *
*     *  * **
* *   *   * *
** *    *   *
***  *   *  *
* **  *  *  *
*    ** *   *
**   * *  ***
*  **** *   *
* * *     * *
*  **       *
*  ** *  *  *
**    ** * **
* **   *    *
***   *     *
*       * * *
** * *    * *
**     *  * *
* *    *    *
*    * * K  *
*    * E  P *
*           *
**  *     * *
***  *   *  *
* **   * *  *
*   ***     *
**       * **
*************