14 17
*****************
*   ** *       **
* **K *   *     *
* * * * *  **   *
**        **    *
* ** * **E  *   *
*  *         *  *
*   *      *    *
**         ** * *
* *   *  ** ** **
*P*        ** * *
*  **   *   *   *
*  *  *    *  * *
*****************