19 13
*************
*  P *     **
**   *      *
**   *     **
*   **  *  **
*     *  * **
* *    **  **
*       ** **
*  *   *  * *
*   **    * *
* *   *  *  *
*  *     *  *
* *  ** *   *
*    **    **
*   *       *
** **  * E* *
***         *
** *K **** **
*************