13 16
****************
*     **  *  * *
* **      * ****
* *     *      *
** * *       * *
* *  *      *  *
* *      *     *
*  *    K   *  *
**   *P ** *   *
*    *     *E **
* *** *     *  *
*    *     * ***
****************