14 21
*********************
*    **      *  *  **
*          *   E    *
** * *P* *    *  *  *
*   ***   *  * *    *
* **   *   *   *   **
**       * *  * * * *
**  *  *            *
**   *  ** * * * *  *
**** * K   *    *   *
**  *              **
* *    * **    *   **
*  ***       *    * *
*********************