15 13
*************
** *     ** *
*** *     * *
* K * *     *
* *        **
* ** ** * P**
*    E*  *  *
*  **   **  *
*      *   **
*        *  *
*  *     *  *
*  ** *     *
***         *
** *  * * * *
*************