14 15
***************
* **    *******
*  * *  *    **
***    E**    *
*  * ** * * * *
*             *
*     * *    **
* *  *  *     *
*  *          *
**  **        *
*  K   * *  * *
*   *   P* *  *
*        **  **
***************