13 17
*****************
* *     * K P * *
*    *  * ***   *
** **    **     *
*         **  * *
*        *  ** **
**        * **E *
*   *** *      **
*  *     *   * **
* *     **  *   *
** *         ** *
* ** *      **  *
*****************