12 18
******************
*       * *     **
**      *    K   *
* *   ** *  * *  *
*     *      **  *
****    *   *   **
**  *  *** P*    *
*   * *   *  *  **
**               *
*      **    *   *
* ** * **E*  **  *
******************