13 25
*************************
*          E         ** *
**     * *****  ** **   *
*    *  **    *        **
*  *  *  * * *          *
*         *  *    * *** *
*   *     **  *        **
**  *  **      *  *     *
*   *P**       **    * K*
* * *  *  *   *   *     *
*    **     * **    ** **
*  **  ** * *   * * **  *
*************************