26 16
****************
*  **  ***     *
*      *  **   *
*      P  *    *
*        * * ***
*      *     K**
*              *
**** ** *     **
*****        * *
*  * * * *    **
*     **   **  *
*   * *    ***E*
**** **        *
**    *        *
**  *     *  * *
**         *  **
* *** *  *     *
*           *  *
* * ****  *   **
*  *    *      *
**   **  **   **
**  * ***     **
**         *  **
*       **     *
*   **  *  *   *
****************