27 15
***************
*  *  *     ***
****** **  ** *
*     *    * **
*    **     * *
*  * * P*     *
*    * **  * **
*    *        *
**   *****    *
* *   ** E    *
*             *
**K     *     *
*   * *       *
*   *  *      *
*   *  * * * **
*    *      ***
*   * * * **  *
**      * **  *
*  **     * * *
*   ****  * * *
**   * * * *  *
*    *      * *
*  ***        *
*  *   *   *  *
* * ***   *   *
*  **   *  *  *
***************