18 15
***************
*    * * * ** *
*   * *       *
*  ***   *    *
*         *  **
*  **     **  *
* **    *    **
*  *  *P * ** *
**    K       *
*  *         **
* * * *    * **
*      * * * **
*    **    ** *
**          * *
*    * *      *
* *  **   E* **
*  * *  *  *  *
***************