12 21
*********************
* * * ** **   *     *
*  * ** P*  *  *   **
*  * *         *    *
* *   *        * *  *
** *  *   *K  **    *
* *    ***       *  *
**  *      ** **  ***
**    *     **  *   *
*        E        * *
*   *   *  * *  *  **
*********************