13 19
*******************
*   ***  *    **K *
** **         *   *
* * P    *   **   *
**   *     * *    *
*   * ***** * * * *
* *   *         ***
*  *  *     ** *  *
*     **        * *
*  E *  *     *   *
* **     * *   ** *
*     *     *    **
*******************