24 12
************
*** * * ** *
* *E * *   *
*  *       *
*  *  * *  *
* ** * * ***
*    * *  **
*   *  * ***
**  *  *   *
*   P     **
**  *    ***
**  *     **
*  *      **
* * *      *
**    **   *
** *    * **
*   *   *  *
* *  ** * **
*       *  *
*  * K     *
* *  **   **
* *        *
*   *   ** *
************