23 18
******************
**  *   *   *** **
* *    ***  *    *
*                *
*  ***   *    ****
*    *    *    * *
*    * *   *     *
* *       *  **  *
* *    *  *   *  *
**   **  *      **
**           * ***
*      *E *    * *
* ** P   * *    **
*  ***   * *    **
*    *      **** *
* **           ***
**    **  *    ***
*  *    *  * *   *
**     * K*   *  *
* *    **     *  *
*  **   * *   ** *
***   *  *  *    *
******************