20 19
*******************
*       * *  ** * *
*     *  ** ** *  *
*    ** **     *  *
* *    *      *   *
*     *       *   *
* **  ***** E*   **
*   *         *  K*
**            *   *
***     *    *  * *
*      P    *  *  *
*** * *  *****   **
*    * *      *   *
**  *  **  *  *  **
*          *  * * *
*  * *  * **   *  *
**  *   * *  *   **
*     * **    * * *
* *** * *    * ****
*******************