22 18
******************
*    E*  *  * *  *
*     ***  *   * *
* **          *  *
** ****  *   *   *
*             *  *
* P*   **        *
**       ** **  **
*  **  ** *    * *
* *  *  ***      *
*  *        *    *
*    *  *     ****
*  *  *   * * *  *
*   *  *  *     **
*  **       **  **
***     *        *
*  * *       *  **
***  K    *  ** **
**      *      * *
*   *    * *  *  *
*   * *    ***   *
******************