18 21
*********************
* * *   *       *   *
*      *  *  **   * *
* *   **  ** *     **
*   *      ** *     *
* *   *   *     P   *
*     **  * *   *  **
*     *  *  *       *
** **    *  * * * * *
**  **  * *   * *   *
**    *    ** *     *
**      *     **  ***
*   *  *   *  ** *  *
* E   *   *     *   *
*  *  K  **      ** *
*    *    *       ***
*           * *  *  *
*********************