16 20
********************
*   *  ** *   **   *
*         *     *  *
* * * **  ** ***   *
*  *  *          * *
**    * *       E* *
*   * * ** * *K ** *
*   *  * *    ***  *
*****  *   *  *    *
*  *      *    *   *
***  *  **  *      *
*  *   *   *    ** *
*    * ** * *  *   *
*   ****      *  * *
*  *P **    *    * *
********************