21 20
********************
*      *  * **     *
**  * *         *  *
*      *       * * *
*     *E          **
** **  **     *   **
* *   *  *  ***   **
*   *   *  *     * *
**    *     **K*  **
*       P**   *  * *
*  *    * * *    * *
*           *      *
** **     *  * * ***
*  *  *       *   **
** ** *    **  *** *
*    *  ** * **    *
*  **  * * *     ***
* *  ****    ** *  *
* * ** *           *
* **      *  *     *
********************